UNINFORMD	Y UW N AH N F AO R M D
HEDGEROW	HH EH JH R OW
ANDALUCÍA	AE N D AH L UW K AH
YOU/	Y UW
SAYLING	S EY L IH NG
SURCOTE	S AH R K OW T
REEDES	R IY IY D Z
FINDEHOW	F IH N D AH HH OW
POISONBREATH	P OY Z AH N B R EH TH
SQUIRRELING	S K W ER AH L IH NG
HATCHT	HH AE CH T
DEGALILEIS	D AH G AH L AY L IY AH S
PROGRESSIVIST	P R AA G R EH S IH V IH S T
ASPISH	AE S AH SH
EVAH	EH V AH
ZHAMEVULL	Z HH AE M AH V AH L
DOWN/	D AW N
TENERIFF	T EH N AH R AH F
BATHROOMWHO	B AE TH R UW M W HH OW
ABLOG	AE B L AH G
GAPES	G EY P S
YELLOWSILK	Y EH L OW S IH L K
MAKEFOR	M EY K F AO R
CREATOUR	K R IY T AH R
EIYEN	IY AY AH N
FLETCHING	F L EH CH IH NG
MUTINIE	M Y UW T AH N IY
USWORSE	AH S W AH R S
ASHTABULA	AE SH T AH B Y UW L AH
TYRANNIC	T AH R AE N IH K
UNBESMIRCHED	AH N B IH S M ER CH T
WATERTHIS	W AO T ER TH IY Z
JONQUIL	JH AA N K W AH L
SMALLED	S M AO L D
NA	N AA
THREAT'NINGS	TH R IY T N AH NG Z
LITYERSES	L IH T IY ER Z IH Z
T'EMBROIL	T EH M B R OY L
UNGROWN	AH N G R OW N
HEARTSPLINTERED	HH AA R T S P L IH N T ER D
HANDWRITINGS	HH AE N D R AY T IH NG Z
UNWOO	AH N W UW
CHILDBREAK	CH AY L D B R EY K
BARRENCOULD	B AE R AH NG K OW L D
MONOLOGUEAND	M AH N AA L AH G W IY N D
NEVERREFERRING	N AH V EH R AH F EH R AH NG
NAMABLE	N EY M AH B AH L
NOTYET	N AA T AY AH T
WASWASN	W AA S W AH Z N
BLITZING	B L IH T S IH NG
STARNBERGERSEE	S T AA R N B AH R JH AH R S IY IY
CAVESSOMEONE	K AH V AH S OW M IY OW N
ANOINTEDTHE	AH N OY N T AH D
EYESBY	AY Z B AY
THEY'ARE	TH EY AH R
CHRYSOSTOM	K R AH S AA S T AH M
DUMBSHIT	D AH M SH IH T
PECKE	P EH K
CHESTSMALLSTUFFPRAYERBOOKGREEN	CH EH S T S M AO L S T AH F P R EY ER B UH K G R IY
ENVOI	IH N V OY
INTERIORLYTO	IH N T AH R AY AO R L AH T OW
MYNSTRELLE	M IH N S T R AH L
BROWEDDIGNITY	B R AW D IH G N AH T IY
LETTETH	L EH T IH TH
FURFURACEOUS	F ER F ER EY S AH S
SEABLUE	S IY B L UW
FLIES•	F L AY Z
WHEATY	W IY T IY
FREAKISH	F R IY K IH SH
REMAINETH	R IH M EY N IH TH
SHOCKSTHAT	SH AA K S TH AH T
IGNOBLY	IH G N AA B L IY
'LIST	L IH S T
FOLKLORES	F OW K L OW R Z
UNAWAKENING	AH N AH W EY K AH N IH NG
LEUDLY	L UW D L IY
OERE	AH R
AMERC'T	AE M AH R K T
WOULDN	W OW L D N
LIGHTTHAT	L AY T TH AH T
SHEWWHAT	SH UW W HH AH T
YARDWORK	Y AA R D W ER K
TUGANN	T Y UW G AH N
THUNDROUS	TH AH N D R AH S
NEOCON	N IY OW K AA N
SHAPEWAFTING	SH AE P Y UW AE F T AH NG
MITERED	M AY T ER D
BUMBOAT	B AH M B OW T
FACEFUL	F EY S F AH L
MOUNDED	M AW N D IH D
WHA	W AA
SERVENTE	S AH R V AH N T
BURNOOSES	B AH R N UW Z AH Z
¿DE	D IY
ARTBUSINESSOF	AA R T B Y UW S AH N EH S AH F
BOWFLEX	B AW F L EH K S
SNEEZEWEED	S N IY Z W IY D
LEEVIN	L IY V AH N
TENNE	T EH N
BLACKAGAINST	B L AE K AH G EY N S T
IMPUT'ST	IH M P AH T S T
TERRORIZERS	T EH R ER AY Z ER Z
LADDERUNTIL	L AE D AH R AH N T AH L
CH3	S IY EY CH TH R IY
LEMONOUT	L EH M AH N AW T
RETHE	R AH DH IY
LISPETH	L IH S P IH TH
GRAYWHACKE	G R EY W HH AH K
UNHANDING	AH N HH AE N D IH NG
FIVEWITH	F AY V W IH TH
LOUNGED	L AW N JH D
LEGISIGNS	L EH JH AH S AH N Z
GIRLANDS	JH AH R L AH N D Z
FOOTERS	F UH T ER Z
PLANTSTO	P L AE N T S T OW
86	EY T S IH K S
STREAMAND	S T R IY M AH N D
WELCOM	W EH L K AH M
HIGHTE	HH AY T
SELFHOOD	S EH L F HH UH D
CINCHING	S IH N CH IH NG
MOOLIT	M UW L IH T
DISTEMPERS	D IH S T EH M P ER Z
1832	W AH N EY T TH R IY T UW
ABATTOIR	AE B AH T OY R
–BILL	B IH L
PÉTROLE	T R OW L
SIDEAND	S AH D IY N D
MARYHILL	M EH R IY HH IH L
OFFLIKE	AO F L AY K
KUROZUKA	K Y UH R AH Z UW K AH
SEVENOAKS	S EH V AH N OW K S
PALEOLITHIC	P EY L IY AH L AH TH AH K
NOBODYIS	N AH B AA D AY AH S
DITS	D IH T S
PAURAQUES	P AO R AH K S
EQUUS	EH K W AH S
GRASSFIRE	G R AE S F AY ER
WALKEDA	W AA L K AH D AH
OTHERMUNICIPALITIES	AH DH ER M Y UH N IH S AH P AE L AH T IY Z
OUTAND	AW T AH N D
SUGARPLUM	SH UH G ER P L AH M
FILETHEN	F AY L IH TH AH N
TRANSUBSTANTIATE	T R AE N S AH B S T AE N T AY EY T
FIFTHLY	F IH F TH L IY
UNBELIEF	AH N B AH L IY F
DELICACIE	D AH L AH K EY S AY
GODWARDS	G AA D W ER D Z
DYSPHASIAS	D IH S EY S IY AH Z
BURNSWRAPPED	B ER N Z R AE P T
LECTEUR	L EH K T AH R
MIEP	M IY P
ILED	AY L D
HEARTACHES	HH AA R T EY K S
BETHER	B IY IH TH ER
EVANGELION	IH V AE N JH AH L Y AH N
DWELS	D W EH L Z
SILKWINGS	S IH L K W IH NG Z
BEDECKEDWITH	B IH D EH K T W IH TH
KAMO	K AE M OW
STROKEIN	S T R OW K IH N
MASSIVEAND	M AE S AH V IY N D
SAANVI	S AA N V IY
HARBORWE	HH AA R B AH R W
SOZZLED	S AA Z AH L D
GENERALIZES	JH EH N ER AH L AY Z IH Z
UNDRAPING	AH N D R EY P IH NG
CARKED	K AA R K T
LAWNAND	L AO N AH N D
MAMO	M AE M OW
UNRAVELLED	AH N R AE V AH L D
CRAGGED	K R AE G D
REINVOKE	R IY IH N V OW K
AVOIDE	AH V OY D
SPITLE	S P IH T AH L
PASTUREONE	P AE S T Y UH R IY OW N
LAYES	L EY Z
SUBSUME	S AH B S UW M
PHILLYP	F IH L AH P
TINCTURED	T IH NG K CH ER D
DISCOMPOSE	D IH S K AH M P OW Z
SPIVS	S P IH V Z
PENTAERYTHRITOL	P EH N T AH R IH TH R AH T AH L
BELIEFTHAT	B AH L IY F TH AH T
MEADOWLARKFROM	M IY D AH L AA R K R AH M
EUPHOTIC	Y UW F AH T AH K
CHARNEL	CH AA R N AH L
SLUGGISHWITHDRAWAL	S L AH G IH SH W IH TH D R AO AH L
SUFFERINGENTITLES	S AH F ER IH NG AH N T AY T AH L Z
BUPRESTIS	B AH P R EH S T AH S
TIMNA	T IH M N AH
PRIMPED	P R IH M P T
ENTERINGAS	EH N T ER IH N G AE S
SCATH	S K AE TH
LEERING	L IH ER IH NG
ALMOSTMONSTRANCE	AE L M AA S T M AA N S T R AH N S
DOESNT	D OW AH Z N T
MANDELSTAM	M AE N D EH L S T AH M
SCREAM–IF	S K R IY M AH F
CENOTAPHS	S EH N AH T AH F S
SEINERS	S AY N AH R Z
LACEWEED	L EY S W IY D
PUCKA	P AH K AH
MISÉRICORDE	M IH S R IH K AH R D
OVERBAKED	OW V ER B EY K T
WEEPINGWHEN	W IY P IH N G W AH N
SUNHAT	S AH N HH AE T
CKIN	K IH N
LASTOF	L AE S T AH F
ROWBOATS	R OW B OW T S
SHRINESTO	SH R AH N EH S T OW
ABIDANCE	AH B AY D AH N S
HERELIKE	HH IH R L AY K
INTERNING	IH N T ER N IH NG
ENCUMBRANCE	IH N K AH M B R AH N S
WORSEFOR	W ER S F AO R
RUDBECKIA	R AH D EH K IY AH
ERFLOWING	AH R F L OW AH NG
BESTOF	B IH S T AA F
RENTALKIND	R EH N T AH L K AY N D
CLACKS	K L AE K S
RESTINGON	R IY S T IH NG AO N
PANCAKING	P AE N K EY K IH NG
SHOOTE	SH UW T
WAGONROAD	W AE G AH N R OW D
FLEECIE	F L IY S AY
TOSWIM	T AA S W AH M
/THEY	DH EY
STIPPLES	S T IH P AH L Z
TENUOUSGROW	T EH N Y AH W AH S G R OW
SNUFFLES	S N AH F AH L Z
CALLETH	K AO L IH TH
ILLTH	IH L TH
MIDNIGHTCONTRIBUTING	M IH D N AY T K AA N T R IH B Y UW T IH NG
CREATINGHOLES	K R IY EY T IH NG HH OW L Z
ROBING	R OW B IH NG
SUBSTRATA	S AH B S T R AE T AH
PROPIO	P R OW P AY OW
TYL	T IH L
LITO	L IH T OW
SMIL'DWITH	S M IH L D W AH TH
PLUNDERS	P L AH N D ER Z
REMOUNTED	R IY M AW N T IH D
PROOFTHAT	P R OW AA F TH AH T
BOGLANDS	B AO G L AE N D Z
SLICKTENTACULARCOLONIAL	S L IH K T AH N T AH K Y AH L AA R K AH L OW N IY AH L
RIPEWITH	R AY P W IH TH
UNDANGEROUS	AH N D EY N JH ER AH S
GREENALL	G R IY N AO L
IMMORTALITYWITH	IH M AO R T AE L AH T IY W IH TH
LOUDSPEAKERSDISAPPEARING	L AW D S P IY K ER Z D IH S AH P IH ER IH NG
SLEEKED	S L IY K T
HALYARD	HH AE L AY AH R D
AYAS	EY AH Z
GOITOM	G OY T AH M
MINUTEAMONG	M IH N Y AH T IY M AH NG
BALAAM	B AE L AH M
SULTANESSES	S AH L T AH N AH S IH Z
REFRIGRATOR	R IH F R IH G R EY T AH R
MINNEGAN	M IH N AH G AH N
BRIMS	B R IH M Z
FRAMEAS	F R EY M IY Z
WOUNDEDCENTAUR	W AW N D AH D S EH N T AH R
DISACKNOWLEDGED	D IH S AE K N AA L IH JH D
UNMOVABLE	AH N M UW V AH B AH L
ORTOLANSEIGHT	AO R T AA L AH N S EY T
GENTIANS	JH EH N CH AH N Z
RADDLE	R AE D AH L
MORNINGSNOW	M AO R N IH NG S N OW
ROOTSOF	R UW T S AH F
SCAMP	S K AE M P
SHARPSHIN	SH AA R P SH IH N
BINCHAILED	B AY NG K EY AH L D
SWAMPLAND	S W AA M P L AE N D
FETHERLITESLUMPED	F AH TH AH R L AH T EH Z L AH M P T
SONGWAS	S AA N G W AH Z
HELIOTROPIC	HH IY L Y AH T R OW P IH K
ONEIT	OW N IY T
CRAWDAD	K R AO D AH D
CHAIRSIN	CH EH ER S IH N
UNTWISTING	AH N T W IH S T IH NG
SVEGETABLE	S V AH JH EH T AH B AH L
ROOTSTOCKS	R UW T S T AA K S
SWIVELLÈD	S W IH V AH L D
PUFIBALL	P Y UW F AH B AH L
THROWNAT	TH R OW N AH T
PENDENT	P EH N D EH N T
SITZBATHS	S IH T S B AH TH S
SHIPSAILS	SH IH P S EY L Z
NOENLARGING	N OW EH N L AA R JH AH NG
RIDGEBACKS	R IH JH B AE K S
LUVV	L AH V
NOSEXUALITY	N AH S EH K S Y UW AE L AH T IY
REQUITED	R IH K W AY T IH D
SUDDEINE	S AH D IY N
DIALECTICS	D AY AH L EH K T IH K S
'LL	EH L
DED	D EH D
DISINTUIT	D IH S IH N T UW AH T
WHITEGIRL	W AY T G ER L
VAGUETHAN	V AE G W AH TH AH N
CLAUSTRO	K L AO S T R OW
CAME–WHO	K AE M Y UW HH OW
80	EY T Z IY R OW
MANAG	M AE N AH G
FEEBLER	F IY B AH L ER
WILLTO	W IH L T OW
AEOLIAN	EH OW L IY AH N
MAAH	M AA
SEATSAT	S IY T S AE T
24:18	T UW F OW R W AH N EY T
SLOUGHED	S L AH F T
'DUG	D AH G
LOA	L OW AH
LOWCOUP	L OW K UW
RAINYDAY	R EY N IY D EY
WASHIE	W AA SH IY
MERTH	M AH R TH
PEYNE	P EY N
TAKESA	T AE K AH S AH
COLLECTINGHEFT	K AA L IH K T IH NG HH EH F T
STAIRWAY/	S T EH R W EY
BLUETTA	B L UW EH T AH
SUNBEAMS	S AH N B IY M Z
REBLOOMS	R IY B L UW M Z
JAMSHID	JH AE M Z HH IH D
RECURRENCES	R IH K ER AH N S IH Z
TOUCHTHROUGH	T AH CH TH R AH F
CUNNER	K AH N AH R
UPBRAIDS	AH P B R EY D Z
MIGHTN	M AY T N
MISTIN	M IH S T IH N
'18	L EH T AH R W AH N EY T
GOOKS	G UH K S
XYLEM	Z AY L AH M
SILLY/	S IH L IY
GODOF	G AA D AH F
FORGETTIN	F AO R G EH T IH N
STEDFAST	S T EH D F AH S T
RECYCLAMENTE	R AH S IH K L AH M AH N T
SHEPE	SH IY P
THEMONE	TH AH M OW N
NEGRAS	N EH G R AH Z
WORKINGI	W AH R K IH N JH IY
INSIGHTFULLY	IH N S AY T F AH L IY
SUBSCRIB	S AH B Z K R IH B
PREFIXED	P R IY F IH K S T
T'ATTEND	T AE T AH N D
ISADORA	AH S AE D AH R AH
ISNESS	AY Z N AH S
SUNSHOT	S AH N SH AA T
LANDLESSNESS	L AE N D L AH S N AH S
UNFURLMY	AH N F AH R L M IY
CAMEI	K EY M IY
IMMORTALITYFOR	IH M AO R T AE L AH T IY F AO R
PHILYP	F IH L AH P
DOWNWARDNESS	D AW N W ER D N AH S
METAPONTUM	M EH T AH P AA N T AH M
DIAGRAMMING	D AY AH G R AE M IH NG
TANKSBENEATH	T AE NG K S B AH N IY TH
RAUCOUSNESS	R AO K AH S N AH S
ONEAT	AO N IY T
CLOATHS	K L OW TH S
GOD…	G AA D
UNBURROWING	AH N B ER OW IH NG
WINDOWSILLS	W IH N D OW S IH L Z
ROCKSAND	R AA K S AE N D
ELEVENTHLY	IH L EH V AH N TH L IY
FRÈRES	F R Z
RIPENS	R AY P AH N Z
GLADDEST	G L AE D AH S T
DISTANTI	D IH S T AE N T IY
QUICKBEFORE	K W IH K B IY F OW R
RHOMBS	R AA M Z
PREFERWHICH	P R IY F AH R W HH AH CH
CADDISWORM	K AE D IY Z W ER M
SIHEK	S IH HH AH K
DOUBLD	D AW B L D
104DISSES	W AH N Z IY R OW F OW R D IY AY EH S EH S IY EH S
UNTAMED	AH N T EY M D
SNIPPING	S N IH P IH NG
MILLIHELEN	M IH L IH HH AH L AH N
THICKETTINKERING	TH IH K AH T IH NG ER IH NG
NURSELY	N ER S L IY
GONEALL	G AO N AO L
DONCQUES	D AO NG K S
UNYIELDINGPAGES	AH N Y IY L D IH NG P EY JH IH Z
TRUSSED	T R AH S T
'GINS	JH IH N Z
UNTHUNDER	AH N TH AH N D ER
FIZZY	F IH Z IY
NOWTHEY	N OW TH IY
AWAYIN	AH W EY IH N
ORBY	AO R B IY
DIRNDL	D AH R N D L
REOITEORA	R IY OY T IY AH R AH
ADDRESSLESS	AH D R EH S L AH S
UNDERGON	AH N D AH R G AA N
CAYSTSUNAMIS	K EY S T S UW N AH M AH S
STUPEFIES	S T UW P AH F AY Z
TASSE	T AE S
IWITHOUT	IH W AH TH AW T
ENCOMIENDA	IH N K AH M IY N D AH
FRAYES	F R EY Z
SEENSO	S IY N S OW
POSTERCAREFULLY	P OW S T ER K EH R F AH L IY
CUTTLEBONE	K AH T L AH B OW N
DYEDWOOLS	D AY D W UH L Z
HUSBANDSWHO	HH AH Z AE N D S W HH OW
PLACESAMONGST	P L AH S EH S AH M AH N G S T
FOLGERSHIP	F OW L JH AH R SH IH P
TOGAS	T AA G AH Z
WHEATLIKE	W IY T L AY K
ITSAID	IH T S EY D
PARTELSEWHERE	P AA R T AH L S UW HH AH R
INNOCENTSTILL	IH N AH S AH N T S T IH L
CAUTIOUSIN	K AO SH AH S IH N
NUDGINGS	N AH JH IH NG Z
EYESYOU	EY EH S AY UW
SUGARPUFF	SH UH G ER P AH F
ABIDEST	AH B AY D AH S T
CHURCHICAL	CH ER CH IH K AH L
RAMPERSAD	R AE M P ER S AE D
WATERD	W AA T AH R D
DISANTPROUSTIAN	D AH S AE N T R AW S CH AH N
ENCE	IH N S IY
THROUGHAND	TH R AW AH N D
ELECTRICI	AH L EH K T R AH S IY
LYMPHOBLASTS	L IH M F AA B L AH S T S
REALEST	R IY L AH S T
PALMETTOES	P AE L M EH T OW Z
BLE	B AH L
RETC	R EH T
XXXV	EH K S EH K S EH K S V
WITHWOMEN	W IH TH W IH M AH N
IFHE	IH F
SACREBLEU	S AE K R EH B L UW
CUI	K UW
INDULGENTLY	IH N D AH L JH AH N T L IY
OLDYOUNG	OW L D Y AH NG
NEARE	N IY R
DINKNESH	D IH NG K N AH SH
ROADSMARKED	R OW D Z M AA R K T
BHÍ	B IY EY CH
OVERPLIED	OW V ER P L AY D
GAYBASHERS	G EY B AH SH AH R Z
MARTINEZHOYNE	M AA R T IH N AH Z HH OY N
STORMFROM	S T AO R M F R AH M
CONVER	K AA N V AH R
FEARAND	F IY R AH N D
LETHARGYTO	L AH TH AA R JH AH T OW
UNKNEADED	AH N IY D IH D
STOMACKS	S T AA M AH K S
PERENIALLY	P AH R AH N AY AE L IY
BITTS	B IH T S
AAHED	AA D
REELETH	R IY L IH TH
IRONWORKS	AY ER N W ER K S
DOLMEN	D OW L M AH N
ARROWIE	AE R OW IY
PHLEGRA	F L EH G R AH
DEVITALIZED	D IY V AY T AH L AY Z D
PROCREATORS	P R OW K R IY EY T ER Z
FOOLSIN	F UW L S IH N
PRESSURELESS	P R EH SH ER L AH S
HIGHBALL	HH AY B AO L
THRILLINGLY	TH R IH L IH NG L IY
CHOC	CH AA K
DEVRIONS	D IH V R AY AH N Z
SUNBLAZED	S AH N B L EY Z D
PUSHINESS	P UH SH IY N AH S
CLUTTERDUST	K L AH T ER D AH S T
STEEPLED	S T IY P AH L D
MEGALONYX	M AH G AE L AH N AH K S
TUAT	T Y UW AH T
PERIPATETICS	P AH R AH P AE T AH T AH S Z
CHURCHESOR	CH ER CH IH Z ER
ALWAYSFLOATING	AE L W EY S L OW EY T AH NG
CASTALY	K AE S T AH L IY
UNWEAVE	AH N W IY V
CORRESPONDENCES	K AO R AH S P AA N D AH N S IH Z
NAMES58,022	EH N EY EH M IY EH S F AY V EY T Z IY R OW T UW T UW
VERTICORDIA	V AH R T AH K AO R D IY AH
VAUT	V AO T
VEGATIVE	V IY G EY T AH V
POLITER	P AH L AY T ER
ANTELOPES	AE N T AH L OW P S
ENDWOMEN	EH N D W IH M AH N
WORLDAS	W AH R L D AH Z
NIGHTCAP	N AY T K AE P
ALSBERG	AE L S B AH R G
ROHMAHNIYAH	R AA M AH N IY AY AH
ALEIAN	EY L IY IY AH N
VOUCHE	V AW CH
ARDOUR	AA R D AH R
FELICITEETHAT	F EH L AH S AH T IY TH AH T
HOOSTE	HH UW S T
SONDAYES	S AA N D EY Z
SPARTINA	S P AA R T AH N AH
ADOD	AE D AH D
TWISTEDINTO	T W IH S T AH D IH N T OW
UNTHANKFUL	AH N TH AE NG K F AH L
BORDERWITHOUT	B AO R D ER W IH TH AW T
EACHOTHER	IY CH AH DH AH R
TEOCALLIS	T IY AH K AE L AH S
LIF	L IH F
PURPLEBLACK	P ER P AH L B L AE K
BLACKMORES	B L AE K M AO R EY Z
TOTOUCHYOUR	T AH T AW CH AY AH R
MAISTER	M EY S T ER
FLIBBERTI	F L IH B AH R T IY
BOUGHDROOPED	B AW D R UW P T
FLUTTRING	F L AH T R AH NG
INTERCESSIONS	IH N T ER S EH SH AH N Z
YOURSELFAND	Y AH R S EH L F AH N D
RETCHES	R EH CH IH Z
TOREST	T OW R AH S T
JOURNEYER	JH ER N IY ER
NESDAY	N EH Z D EY IY
CALLOWS	K AE L OW Z
PRICKLESOF	P R IH K L AH S AH F
ERUCTATIONS	EH R AH K T EY T IY AH N Z
KLINGELSCHILD	K L IH N JH EH L S AH L D
CONNAJOHRY	K AA N AE JH AH R IY
FORBEARFORBEAR	F AO R B AE ER F AO R B AE ER
PIPISTRELLO	P IH P AH S T R EH L OW
CHALEUR	CH EY L AH R
CHUSING	CH UW Z AH NG
LISTENANYMORE	L IH S T AH N AE N AH M AH R
PYRAMID6	P IY W AY AA R EY EH M AY D IY S IH K S
O'ERVAULT	AH AH R V AH L T
REVEALNO	R AH V EH L N OW
NAIADS	N EY AH D Z
ENDOCARP	EH N D UW K AA R P
CROCKED	K R AA K T
TALLEYRAND	T AE L EY R AH N D
EXTERNALITY	EH K S T ER N AH L AH T IY
HEVE	HH IY V
EXPRMNTL	EH K S R M N T L
HAND…	HH AE N D
UNBEHOLDEN	AH N B IH HH OW L D AH N
GOLDSMITHS	G OW L D S M IH TH S
BROIDERS	B R OY D AH R Z
AGUES	EY G Y UW Z
SENDAL	S EH N D AH L
RACEOF	R EY S IY AH F
MELODIST	M EH L AH D AH S T
RIVE	R AY V
NOTEVEN	N AA T AH V AH N
***	
LIGHTSEEKERS	L AY T S IY K ER Z
BLOSSOMSIN	B L AA S AH M S IH N
YOUTHWHO	Y AW TH W HH OW
UNFASTIDIOUS	AH N F AE S T IH D IY AH S
STRONG/	S T R AO NG
CLUMSIEST	K L AH M Z IY AH S T
QUICKLIME	K W IH K L AY M
ABWESENDEN	AE B W AH S EH N D AH N
THANKSGIVIN	TH AE NG K S JH AH V AH N
PLAINE	P L EY N
DEERFLIES	D IH ER F L AY Z
8IF	EY T AY EH F
SWEREEE	S W IH R IY IY IY
UNSTUFFING	AH N S T AH F IH NG
DISCOV	D IH S AA V
THEREALMOST	TH IY R IY L M OW S T
TRUM	T R AH M
SEARCHEST	S ER CH AH S T
PAPAGOS	P AA P AH G OW Z
LAWRELL	L AO R AH L
TREEOF	T R IY AH F
SCEPTICISM	S K EH P T AH S IH Z AH M
ROSETHE	R AA S AH DH
CATARRHS	K AE T AH R Z
SHILLY	SH IH L IY
EBBOF	EH B AH F
SEISTAN	S AY S T AH N
AMREPULSED	AE M R EH P Y AH L Z D
FLEAWORTS	F L IY W AO R T S
IMPOW'RD	IH M P OW R D
IMMENSEAND	IH M EH N S IY N D
TALKT	T AE L K T
TOSTACHDON	T AA S T AE CH D AH N
TWYNE	T W AY N
UNFEARD	AH N F AH R D
NATIONSTHE	N EY T IY AH N S DH
SYLLABLESAS	S IH L AE B L AH S AH Z
PERVERSNESS	P AH R V AH R S N AH S
CRAMM	K R AE M
SING•	S IH NG
EIGHTHE	EY DH
TOSMACK	T AA Z M AH K
WING…	W IH NG
FOTED	F OW T AH D
UNTWINE	AH N T W AY N
WITHINTHIS	W IH TH IH N TH IY Z
CHATTERS	CH AE T ER Z
PULSENOT	P UH L S AH N AH T
FOREDOOM	F OW R D UW M
2003	T UW Z IY R OW Z IY R OW TH R IY
SMELLSEXACTLY	S M EH L S EH K S AE K T L IY
ASHFORK	AE SH F AO R K
LINESWHICH	L AH N EH S W HH AH CH
GIVN	JH IH V N
WINDINGS	W IH N D IH NG Z
CREATURESWHOSE	K R IY T Y UH R AH S W HH OW Z
INJEEL	IH N JH IY L
TORTOISESHELL	T AO R T AH S SH EH L
SOCKETING	S AA K AH T IH NG
TRUSTNOR	T R AH S T N AH R
NIGHTLIGHT	N AY T L AY T
CONCRETE/WITH	K AA N K R IY T W IH TH
DOVESMALL	D AH V S M AO L
ATREIDES	AE T R IY D Z
ESPINAS	EH S AH N AH Z
IVORIES	AY V AH R IY Z
UPWHEREVER	AH P W HH AH R IY V AH R
ELFINS	EH L F AH N Z
CLIMBTHROUGH	K L AY M TH R AH F
THUMBSCREWS	TH AH M S K R UW Z
HARDYNESSE	HH AA R D AH N AH S
QUATTROCENTO	K W AA T R AH S EH N T OW
RECORDLESS	R IH K AO R D L AH S
SCÈNE	S K N
NOCTURNALS	N AA K T ER N AH L Z
ADMHÓDH	AE D M HH D
STETHOSCOPEAND	S T AH TH AA S AH P IY N D
DIDDLED	D IH D AH L D
SILOES	S AY L OW Z
FOUNDAT	F AW N D AH T
ADOWN	AH D AW N
MARKEDGREEN	M AA R K T G R IY N
CHASUBLE	CH AH S UW B AH L
DISPENCE	D IH S AH N S
EYES/	AY Z
DRUARTAUD	D R UW W AA R T AH D
MAWED	M AO D
TABARD	T AE B AH R D
RESIGNEDLY	R IH Z AY N AH D L IY
UNHOOKED	AH N HH UH K T
JUSTFINGERTIPS	JH AH S T F IH NG G ER T IH P S
YPOINTING	Y P OY N T AH NG
DISCOURSEIS	D IH S K OW R S IY Z
VIMY	V AY M IY
SLABINTO	S L AH B IH N T OW
BESIEG	B AH S IY G
LEAVESTHAT	L IY V AH S T HH AE T
THINKTHAT	TH IH NG K TH AH T
SORCERORS	S AO R S AH R AH R Z
2026	T UW Z IY R OW T UW S IH K S
ITTO	IH T OW
NAMESAND	N EY M S AE N D
BYCATCH	B AY K AE CH
STERBEN	S T AH R B AH N
KNYGHTLY	N IH T L IY
VICTORYTHE	V IH K T AH R AH DH
ATWITTER	AH T W IH T ER
REBROKEN	R IY B R OW K AH N
CHAMPOEG	CH AE M P OW AH G
HOLINIGHT	HH AA L AH N AY T
//////	
SIDESWIPE	S AY D S W AY P
LAUNDROMATDESTROYING	L AO N D R AH M AH T D EH S T R OY AH NG
UNDUTIFUL	AH N D UW T IY F AH L
GOESAND	G OW AH S AH N D
BENEDIGHT	B IH N AH D AY T
FASTACROSS	F AE S T AH K R AO S
BORDERCROSSER	B AO R D ER K R AO S ER
LEECHED	L IY CH T
AIRA	AE AH R AH
BOWLBABA	B OW L B AH B AH
UNANALYSED	AH N AE N AH L AY Z D
PAPERENDURING	P EY P ER EH N D Y UH R IH NG
SUFFISE	S AH F AY Z
JABÈCHANDLERVILLE	JH AE B CH AH N D L AH R V AH L
CHORUSING	K OW R AH S IH NG
CONTINUED'ST	K AA N T IH N Y UW AH D S T
RESTSTATIONS	R EH S T S T EY SH AH N Z
KNOTGRASS	N AA T G R AE S
PREFIGURE	P R IY F IH G Y ER
SNIPPITUIT	S N IH P AH T UW T
GOGOL	G AA G AH L
SPELK	S P EH K
JAILBIRD	JH EY L B ER D
LATEDOOM	L EY T D UW M
SULPHUROUS	S AH L F ER AH S
KDALLDORF	K D AE L D AH R F
LESAR	L Z AE R
DAINTINESS	D EY N T IY N AH S
FLOWERSFIST	F L AW ER Z F IH S T
SPIRITUALPAUPERS	S P IH R IH CH AH W AH L P AO P ER Z
NUMBERLESS	N AH M B ER L AH S
INSPIRATIONOF	IH N S IH R AH T IY AH N AH F
DARKENS	D AA R K AH N Z
SHHHH	EH S EY CH EY CH EY CH
FACTUALIZING	F AE K CH AH W AH L AY Z IH NG
AVERRE	AE V AH R
ABAJO	AE B AH JH OW
TIMBALS	T IH M B AH L Z
SKIDDAW	S K IH D AH
DUSTDEVILS	D AH S T D EH V AH L Z
CROONED	K R UW N D
CIVILIZATIONAND	S AH V IH L AH Z AH T IY AH N AH N D
CUNTS	K AH N T S
TAMBOURINES/	T AE M B AH R IY N Z
DUFY	D Y UW F IY
GAOL	G EY AH L
SUSPECTEDGOD	S AH S P EH K T IH D G AA D
GARBAGEY	G AA R B IH JH IY
CAWS	K AO Z
LAMMA	L AE M AH
TIERGARTEN	T IY R G AA R T AH N
WILDLEAN	W AY L D L IY N
ANGELICK	AE N JH AH L AH K
WOGS	W AA G Z
HOOHOOOOIF	HH UW HH UW UW AH F
PROTEUS	P R OW T IY AH S
ROOTSINTO	R UW T S IH N T OW
AUTOCHTHONOUS	AH T AA CH TH AH N AH S
WAVESWHILE	W AH V EH S W AH L
INDRAWN	IH N D R AO N
PARLEYING	P AA R L IY IH NG
TVWHILE	T V W HH AY L
CURIOUSITY	K Y UH R IY AH S AH T IY
EINNOCENCEDESERVING	IY N AH S EH N S EH D AH S AH R V AH NG
OFFCUTS	AO F K AH T S
JASMINES	JH AE Z M AY N Z
KHOLE	K HH OW L
HARDFOR	HH AA R D F AO R
IDLEUNDER	AY D AH L AH N D ER
KHOUNDDOG	K HH AW N D AH G
CHAINMAIL	CH EY N M EY L
ZIGGURATSIN	Z IH G Y AH R AE T S AH N
INCHESBROWN	IH N CH IH Z B R AW N
FOETUS	F OW AH T AH S
PRESENCEOF	P R IY S EH N S IY AH F
SEAMUSIC	S IY M Y UW Z IH K
DEEVER	D IY EH V ER
THUNDERCLOUD	TH AH N D ER K L AW D
CLUMPED	K L AH M P T
CREAKTHROUGH	K R IY K TH R AH F
LORDSITS	L AO R D S IH T S
PERFET	P AH R F EH T
VRENCH	V R EH N CH
THÉACHTADH	TH AE CH T AH D
PROMISCUITIES	P R OW M IH S K Y UW AH T IY Z
UNDISTURBÈD	AH N D AH S T AH R B D
GESTICULATES	JH EH S T IH K Y AH L AH T S
CROTON	K R AA T AH N
STRASZUN	S T R AE Z AH N
LENETH	L IY N AH TH
STITCHEDTHIS	S T IH CH T TH IY Z
DISOPROXIL	D AH S AA P R AA K S AH L
TAPEWORM	T EY P W ER M
FLUTTRYNG	F L AH T R AH NG
MALDON	M AE L D AA N
DEADWHOSE	D IY AE D W HH OW Z
INCONSTANT	IH N K AA N S T AH N T
BARNSTAPLE	B AA R N S T EY P AH L
HEADADORNED	HH EH D AH D AO R N D
CALLUSED	K AE L AH S T
BECKONINGS	B EH K AH N IH NG Z
BROWNSPRAWLS	B R AW N S P R AO L Z
DUCCIO	D AH K S IY OW
TIMELORD	T AY M L AO R D
TUBEROUS	T UW B ER AH S
LIGHTWHITE	L AY T W AY T
OUTJOURNEYING	AW T JH ER N IY IH NG
GALOOTS	G AH L UW T S
FOCO	F OW K OW
DROSERA	D R AA S AH R AH
REALMES	R IY AE M Z
TRANSISTANCE	T R AE N S IH S T AH N S
LUBBARD	L AH B AH R D
CLOUDLET	K L AW D L AH T
PIROGI	P IH R AH JH IY
CYCLOPEDIA	S IH K L AH P IY D IY AH
SPINNIES	S P IH N IY Z
TOYNBEE	T OY N B IY IY
CAECIAS	K IY S IY AH Z
COV'NANT	K AA V N AH N T
SHRINKETH	SH R IH NG K IH TH
GLANVIL	G L AE N V AH L
INBOX	IH N B AA K S
SHIELDE	SH IY L D
BISERTA	B AY S AH R T AH
PROWDE	P R OW W D IY
DAMEN	D EY M AH N
MONSTERGOD	M AA N S T ER G AA D
DIPTHERIA	D IH P TH IY R IY AH
ARTEMISIA	AA R T AH M IH ZH IY AH
MEÄLS	M EH L Z
MANGOLA	M AE N G AH L AH
HOARDINGS	HH OW R D AH NG Z
WHEELHOUSE	W IY L HH AW S
POTSOF	P AA T S AH F
TREESHRUBS	T R IY SH R AH B Z
STOVEIT	S T OW V EY T
GYMNOSOPHIST	JH IH M N AA S AH F AH S T
CORVID	K AA R V IH D
SCULLS	S K AH L Z
MYTHISTOREMA	M IH TH AH S T AO R AH M AH
STEPSTO	S T EH P S T OW
UNDESERV	AH N D AH S AH R V
SHRIVED	SH R AY V D
RIESIGEN	R IY S AH JH AH N
DALGARNOCK	D AE L G AA R N AH K
KNORREN	N AO R AH N
ENDEVORING	EH N D IY V ER IH NG
UNWEAVES	AH N W IY V Z
OFFYOUR	AA F AY AH R
WINDROWS	W IH N D R OW Z
SNAKELESS	S N EY K L AH S
CELLULITE	S EH L AH L AY T
ANCOR	AE NG K AH R
ROTBEFORE	R AA T B IY F OW R
RENOUN	R IY N AW N
SOUNDS/	S AW N D Z
*TURN	T ER N
BRIEFAMBITION	B R IY F AE M B IH SH AH N
TROUSSEAU	T R AW S IY UW
COVEYSWORTH	K OW V IY Z W ER TH
MYGHT	M IH T
POLYHEDRAL	P AA L AH HH EH D R AH L
HARDWIRE	HH AA R D W AY ER
FLARESIN	F L EH R S IH N
JUSTBELOW	JH AH S T B IH L OW
CP	S IY P
OVERGROW	OW V ER G R OW
UNSHROUDED	AH N SH R AW D IH D
SAHARAS	S AE HH AH R AH Z
WÓULD	W AH L D
WEEDSPORT	W IY D S P OW R T
LOBOTOMIES	L OW B OW T OW M IY Z
BENYGNE	B AH N IH N
SWERDES	S W AH R D Z
ABAYA	AE B EY AH
CAGEIS	K EY JH IY Z
WINEPRESS	W AY N P R EH S
WOOOOOOO	W UW UW UW OW
O'NIGHTS	AA N AY T S
WAHA	W AA HH AH
EMÒN	EH M
YELLOWIN	Y EH L OW IH N
LOWNOTE	L OW N OW T
CALFTHAT	K AE L F TH AH T
DIAPRED	D AY AH P AH R D
FLANG	F L AE NG
ARIDNESS	AE R AH D N AH S
ELPHINSTONE	EH L F AH N S T OW N
POINTILLISTIC	P OY N T IH L IH S T IH K
CUEBALLS	K Y UW B AO L Z
VARICOLORED	V EH R IH K AH L ER D
SARAMAGO	S AH R AE M AH G OW
BLOSSOMLIKE	B L AA S AH M L AY K
OCD	AA K D
CONGERIES	K AA N JH AH R AY Z
MONTEAGLE	M AA N T IY G AH L
OCHRED	OW K ER D
NONOFFICE	N AA N AO F AH S
UNBANDAGED	AH N B AE N D IH JH D
REDBIRDS	R EH D B ER D Z
CERTAINTIESTHAT	S ER T AH N T IY AH S T HH AE T
FRIENDBRINGS	F R EH N D B R IH NG Z
YAWPS	Y AO P S
NAWWAYS	N AH W EY Z
FLUTTERINGOF	F L AH T AH R IH N G AH F
DESPARECEN	D IY S P AA R IY S AH N
FILTERTO	F IH L T AH R T OW
CONCORDANT	K AH N K AO R D AH N T
OFGELISTENEDTAKING	AA F JH AH L IH S T EH N AH D T EY K AH NG
BODYBUILDER	B AA D IY B IH L D ER
ERBLOWN	AH R B L OW N
OLLOW	AA L OW
DREAMTTWO	D R IY M T W OW
SISTERSLOW	S IH S T ER S L OW
VOYELLES	V OY AH L Z
BEFORESOMETHING	B IH F OW R S AH M TH IH NG
QUAKINGLY	K W EY K IH NG L IY
REDBICYCLE	R EH D B AY S IH K AH L
GREENACROSS	G R IY N AH K R AO S
DISORGANIZES	D IH S AO R G AH N AY Z IH Z
ROKKU	R AA K UW
PEOPLETHEMSELVES	P IY P AH L IH TH IH M S EH L V Z
OFFTHE	AA F DH
BRAYING	B R EY IH NG
STEEKS	S T IY K S
SCRUTINISED	S K R UW T AH N IY Z D
DESTIND	D IH S T AY N D
WAYLIKE	W EY L AY K
QUELQUE	K W EH L K
HEREUPON	HH IY R UW P AH N
TRACKEDPLANETARY	T R AE K T P L AE N AH T EH R IY
CHARGEWE	CH AA R JH UW
WHIMPEREDTHE	W IH M P AH R AH D
TWOWHEN	T W OW AH N
FLIGHTSARE	F L AY T S AH R
/BROWN	B R AW N
OTHERS–	AH DH ER Z
BORWICK	B IY ER W IH K
ATTACHBECAUSE	AH T AE CH B IY K AO Z
PEELINGS	P IY L IH NG Z
MOREOPPRESSIVE	M AO R IY AA P R AH S AH V
STEDS	S T EH D Z
MEDICYNE	M EH D AH S AY N
CORSAGES	K AO R S AA ZH IH Z
MURIE	M Y UH R AY
PISTONED	P IH S T AH N D
CONVENESOME	K AH N V IY N S AH M
LYSTE	L IH S T
BRYDE	B R AY D
BRASTE	B R EY S T
WORDFOLLOWED	W ER D F AA L OW D
OFIRE	OW F AY R
WHATI	W AA T IY
SADISTS	S EY D AH S T S
PULLE	P Y UW L
EXPANSIVENESS	IH K S P AE N S IH V N AH S
PRIZEAROUND	P R AY Z AH R AW N D
MAYAGÜEZ	M EY AH JH AH Z
DEEDE	D IY IY D
IMPERISHABLE	IH M P EH R IH SH AH B AH L
METU	M EH T UW
COMELEY	K AH M IY L IY
SPHERIC	S F IH ER IH K
REVOLUTION…	R EH V AH L UW SH AH N
WINDTHE	W IH N D
PATENTE	P AE T AH N T
UREWIGGIRLS	Y UH R UW IH JH AH R L Z
PALMSAND	P AA M S AE N D
SOMOSIERRA	S AA M AH S IY R AH
REDNECKED	R EH D N EH K T
DUTIE	D Y UW T AY
PERNICKETY	P AH R N IH K AH T IY
TURNUPS	T ER N AH P S
BETROTHED	B IH T R AO TH T
TURNINGTHE	T AH R N AH N G
SPRENGED	S P R EH NG D
PANTALETTES	P AE N T AH L EH T S
'ISÉN	IH Z N
MYRIADS	M IH R IY AH D Z
RUPTRESTFACES	R AH P T R EH S T AH S AH Z
REWRITABLE	R IY R AY T AH B AH L
HUGGERMUGGER	HH AH G ER M AH G ER
DELIRIOUSLY	D AH L AH R IY OW AH S L IY
CORROBORATEDBY	K AH R AA B ER EY T IH D B AY
NOTSMOKING	N AA T S M OW K AH NG
CRYNE	K R AY N
LIFTABLE	L IH F T AH B AH L
GHOSTLINGS	G OW S T L IH NG Z
FRONTSIDE	F R AH N T S AY D
HIBACHIS	HH IY B AA CH IY Z
RICEFIELDS	R AY S F IY L D Z
UNDERHAIRS	AH N D ER HH EH R Z
BABLES	B IY AH B AH L Z
AVOUCH	AH V AW CH
GOATSKINS	G OW T S K IH N Z
CHASEBENEATH	CH AH S EH B AH N IY TH
DAUNCE	D AO N S
TEMP'RANCE	T EH M P R AH N S
NITRE	N AY T AH R
BLOWSTHE	B L OW S DH
APOLOGIZETO	AE P AH L AH JH IH Z AH T OW
ANALYSE	AE N AH L AY Z
SACKCLOTH	S AE K L AO TH
CARAVANSARY	K AE R AH V AE N Z EH R IY
ALOÄN	AE L AH N
DESCANT	D IY S K AE N T
OPERANTES	AA P AH R AH N T S
PÈRE	P AH R
LENTCHARGE	L EH N T CH AA R JH
TURBIDLY	T AH R B IH D L IY
UNLEAFING	AH N L IY F IH NG
ONEBUT	AA N AH B AH T
LEARNEDHOW	L AH R N EH D HH OW
COND	K AA N D
RESIZE	R IY S AY Z
SPRINGGENTLY	S P R IH NG AH N T L IY
TIGHTAND	T AY T AH N D
'DIN	D IH N
WHITESMOKE	W AY T S M OW K
WIR	W IH R
HOMEAND	HH OW M IY N D
GAMEBUT	G AE M AH B AH T
STREWMENTS	S T R UW M AH N T S
HATCHWAY	HH AE CH W EY
LEAGUERSNEVER	L IY G W AH R S N IY V AH R
LEADER/OPERATIVE	L IY D ER AA P ER AH T IH V
EPIPHANO	AH P IH F AH N OW
GIRLES	JH AH R L Z
CROSSAT	K R AA S AH T
PIGGIES	P IH G IY Z
PROSCRIBING	P R OW S K R AY B IH NG
FRAOIGHISTEACH	F R EY OY AH S T IY CH
BUDDINGS	B AH D IH NG Z
SILENTNESS	S AY L AH N T N AH S
SWEATIN	S W EH T IH N
EMBOWELD	IH M B AW EH L D
TELENOVELAS	T EH L AH N AA V AH L AH Z
AFLAMEIN	AH F L EY M IH N
VERZEICHNET	V AH R Z IY K N AH T
EMBASED	IH M B EY S T
UNLAY	AH N L EY
PORKA	P AO R K AH
WAYBECAUSE	W EY B IY K AO Z
GNOSTICALLY	N AA S T AH K AE L IY
1870–71	W AH N EY T S EH V AH N Z IY R OW S EH V AH N W AH N
THECHINESE	TH EH CH AH N IY Z
SHORTENINGAS	SH AO R T AH N IH N G AE S
NIGHTMIND	N AY T M AY N D
WIDDERSHINS	W IH D AH R SH AH N Z
FLICKOF	F L IH K AH F
CHITERATES	CH IH T AH R EY T S
ARESKELETONS	AH R IY S K EH L AH T AH N Z
WINNEPESAUKEE	W IH N EH P AH S AH K IY IY
IDOLIZ	IH D AH L AH Z
IMMORTALLY	IH M AO R T AH L IY
SEEKE	S IY K
XXVI	Z K S V IY
EATSHIS	IY T SH AY Z
MITRAILLEUSE	M IH T R EY L UW Z
UNWARILY	AH N W AE R AH L IY
USURPT	Y UW S AH R P T
BLEETS	B L IY T S
CRINOLINE	K R IH N AH L AY N
UNDERGUILT	AH N D ER G IH L T
TAINED	T EY N D
LEGSALMOST	L EH G Z AH L M OW S T
ÉTERNITÉ	T AH R N AH T
BRIGANTINES	B R IH G AH N T IY N Z
DRAWERFUL	D R AO R F AH L
ABANDONMENTDEVELOPED	AH B AE N D AH N M AH N T D IH V EH L AH P T
KIRCHSTETTEN	K AH R CH S T EH T AH N
HEREWHO	HH AH R UW HH OW
CREEKSTONE	K R IY K S T OW N
RESEMBLEA	R AH S EH M B L IY AH
PERSECUTERS	P ER S IH K Y UW T ER Z
URL	AH R L
TARTARE	T AA R T AH R
*EPILOGUE	EH P AH L AO G
ONWARDSON	AO N W AO R D S AH N
WEISMULLER	W IY Z M UH L AH R
SIMPLICETTA	S IH M P L AH S EH T AH
BLINDEYE	B L AY N D AY
PVBLICAM	V B L IH K AH M
RICHT	R IH CH T
GORM	G AO R M
GRRR	JH IY AA R AA R
FIX'T	F IH K S T
SUITAN	S UW T AH N
NEARBYISLANDA	N AH R B AY AH Z L AE N D AH
TAMPOCO	T AE M P AH K OW
CENSED	S EH N Z D
WHILK	W IH K
TEMPORIZERS	T EH M P AH R AY Z ER Z
SAIDONE	S EY D OW N
SLENDERER	S L EH N D ER ER
HACKLED	HH AE K AH L D
LUSTRES	L AH S T ER Z
POSTESSES	P OW S T AH S IH Z
CHIMNEYVILLE	CH IH M N EY V AH L
KNOWSALL	N OW Z AO L
FAILLE	F EY L
BASIT	B AE S AH T
UNMOVD	AH N M AA V D
RIBB	R IH B
ORPHAS	AO R F AH Z
SUPE	S UW P
PÉREZ	P R EH Z
SPACESO	S P AE S AH S OW
ADENTRO	AH D EH N T R OW
BADASSED	B AE D AE S T
NIGHTSSHE	N AY T S
WARPINGS	W AO R P IH NG Z
BEERTO	B AH AH R T OW
DISSEIZED	D IH S IY Z D
WAFTS	W AA F T S
NIGGASWHO	N IH G AE S W HH OW
TAILQUICKSILVER	T EY L K W IH K S IH L V ER
'AÄPOTH	AE P AH TH
1790	W AH N S EH V AH N AY N Z IY R OW
SPEEDE	S P IY D
NULL	N AH L
CATCHA	K AE CH AH
CARAGANA	K AH R AE G AH N AH
WORKHOUSES	W ER K HH AW S IH Z
PERSIMMON	P ER S IH M AH N
INTOXICATINGBUT	IH N T AA K S AH K AH T IH N G AH T
CURRANT	K ER AH N T
:	
HAUNTEN	HH AO N T AH N
COMPELLD	K AA M P EH L D
COVERTURES	K AH V ER CH ER Z
DIVAGATIONDIVAGATIONS	D AY V IH JH EY SH AH N D AY V IH JH EY SH AH N Z
UNSEALING	AH N S IY L IH NG
TITLEMEANING	T AY T AH L M IY N IH NG
MOLEHILLS	M OW L HH IH L Z
WITHOUR	W IH T AW ER
WONDRES	W AA N D AH R Z
UNSPUN	AH N S P AH N
ELUCIDATION	IH L UW S AH D EY SH AH N
DUSTSWEEPS	D AH S T S W IY P S
LIPSED	L IH P S T
CHEAR	CH IY AH R
OVERSHONE	OW V ER SH OW N
BALANCEDEFEAT	B AE L AH N S D IH F IY T
VERDURAS	V AH R D Y AH R AH Z
GRISTLY	G R IH S T L IY
LANDHORSE	L AE N D HH AO R S
FALLENFROM	F AE L EH N F R AH M
PITILESSLY	P IH T IY L AH S L IY
EARTHIE	ER TH IY
UNDERGROUNDTO	AH N D AH R G R AW N D T OW
FERNE	F AH R N
BLEMISHING	B L EH M IH SH IH NG
CHAMORU	CH AE M AH R UW
MÍCARCERID	M K AA R S AH R AH D
FRESCA	F R EH S AH
CHAMOMILE	CH AH M OW M AH L
COWFLATWORM	K AW F L AE T W ER M
CANTOS	K AE N T OW Z
TETHERINGLINEN	T EH DH ER IH NG L IH N AH N
NAPOLÉONS	N AE P AH L AH N Z
PLAME	P L EY M
BLOODIN	B L AH D IH N
VERNED	V AH R N D
COCKERMOUTH	K AA K ER M AW TH
LIVEON	L IH V AO N
1858	W AH N EY T F AY V EY T
FRASCATI	F R AE S AH T IY
BESEEMING	B IH S IY M IH NG
PAINTAN	P EY N T AE N
GOINGA	G OY N G AH
INSENTIENT	IH N S EH N CH AH N T
MWORE	M W AO R
JOLLITY	JH AA L AH T IY
GAINEDAND	G EY N AH D AH N D
RECEIV	R AH S IY V
PELUCID	P AH L UW S AH D
HIGHLYOF	HH AY L AY AH F
SKINMOUST	S K IH N M AW S T
LESTER/	L EH S T AH R
HERTFORDSHIRE	HH AH R T AH R D SH AY R
FRAG	F R AE G
HOUSETHE	HH AW S AH DH
BLINDERED	B L AY N D ER D
CANCELLATED	K AE N S AH L EY T IH D
ROBEAROUND	R OW B AH R AW N D
GLASSIN	G L AE S IH N
PARVYS	P AA R V AH Z
GAVEDAVID	G EY V D AE V AH D
ENTRAILSSPILLING	EH N T R EY L Z S P IH L IH NG
TJALONARANG	T JH AH L AA N AH R AH NG
GUELF	G Y UW AH L F
VALOUR	V AE L AH R
SQUIDGICUM	S K W IH JH AH K AH M
INTELLECTUALSRAISED	IH N T AH L EH K CH AH W AH L Z R EY Z D
QUIERE	K W IY R
HAZARDED	HH AE Z ER D IH D
BECAUSEOF	B AH K AO S IY AH F
AGILITIES	AH JH IH L AH T IY Z
DEVYNE	D AH V AY N
BOUNDARIED	B AW N D R IY D
SPACEMAN	S P EY S M AE N
UNSHAR	AH N SH AH R
UNBUCKLES	AH N B AH K AH L Z
PAHXIMATRAPTHEM	P AE K S AH M AH T R AE P TH AH M
STILLORGAN	S T IH L AO R G AH N
AREREAL	AH R IY R IY L
SQUEAKAT	S K W IY K AH T
PEERINGLY	P IH ER IH NG L IY
OMNIVORES	AA M N AH V AH R Z
SEDGESEDGE	S EH JH AH S AH JH
PARTAKER	P AA R T EY K ER
TSTROKE	T S T R OW K
SEUENTY	S UW EH N T IY
YESLET	Y IY Z L AH T
MAGNIFI	M AE G N AH F IY
HILLROSE	HH IH L R OW Z
SILUETA	S AH L UW AH T AH
LOSTNESS	L AO S T N AH S
KEENIN	K IY N IH N
FOODYOU	F UW D AY UW
NEEDINESS	N IY D IY N AH S
HATCHLINGSHE	HH AE CH L AH N G SH
DOWNBECAUSE	D AW N B IY K AO Z
BLUEJUST	B L UW JH AH S T
ZORILLAS	Z AH R IH L AH Z
PROTECTAGAINST	P R OW T EH K T AH G EY N S T
RAVENING	R EY V AH N IH NG
INCREAST	IH N K R IY S T
MYST	M IH S T
SPEAKABLE	S P IY K AH B AH L
SEPULTURE	S AH P UH L T Y AH R
COVERSWE	K OW V AH R S W
8OO	EY T OW OW
PARISII	P AE R AH S IY
CLATTERS	K L AE T ER Z
IDIOCIES	IH D IY AH S IY Z
STILLAS	S T IH L AH Z
CUKE	K Y UW K
BONNARD	B AA N AH R D
INCENDIARIES	IH N S EH N D IY EH R IY Z
BERKELEYOR	B IH R K IY L EY AH R
SPOTON	S P AA T AO N
PHEU	F Y UW
COQUETILLA	K OW K W AH T IH L AH
ENTOMBS	EH N T UW M Z
ENCRYPTON	EH N K R IH P T AO N
CHOICE/OR	CH OY S AO R
STREETCORNER	S T R IY T K AO R N ER
LO'ED	L OW Z D
CHITTERLING	CH IH T AH R L AH NG
WALKTHE	W AA L K DH
INSUBSTAN	IH N S AH B Z T AE N
CUMMING8	S IY Y UW EH M EH M AY EH N JH IY EY T
ACCOMODATION	AE K AA M AH D EY SH AH N
JACKETLESS	JH AE K AH T L AH S
BIRKEN	B AH R K AH N
MAGMASHADES	M AE G M AH SH EY D Z
BOWSPRITS	B OW S R AH T S
FREUDIER	F R UW D AY AH R
CREMATES	K R IY M EY T S
ADVANTAG	AE D AE N T AH G
REINGA	R IY AH N G AA
BLOCKINGTHE	B L AA K AH N G
FIST/DAP/POUND/AND	F IH S T D AE P AW N D AE N D
SKYOXYGEN	S K AY AA K S IH JH AH N
URIAH	Y UH R AY AH
HOURWOULD	HH AH R W OW L D
FALBALAS	F AE L B AH L AH Z
SILKO	S IH L K OW
INTRUDINGI	IH N T R AH D IH N JH IY
ND	EH N D
UNDIVORCEABLE	AH N D AH V OW R S AH B AH L
SOVREIGN	S AA V R EY N
WHEELSBEATING	W IY L Z B IY T IH NG
CARCAJADAS	K AA R K AE JH AH D AH Z
POMMELLED	P AA M AH L D
SAVEMY	S AE V AH M IY
ASKTHAN	AE S TH AH N
MONSOONSAND	M AA N S UW N S AE N D
PLIEST	P L AY AH S T
HOBGOBLINS	HH AA B AA B L AH N Z
MIDDLEAND	M IH D L IY N D
'29	L EH T AH R T UW N AY N
GONEDOWNTOWN	G AO N D AW N T AW N
UNCOMFRTABLE	AH N K AA M F R T AH B AH L
ADJOYN	AE JH OY N
MEWHAT	M Y UW HH AE T
COWGIRLS/THE	K AW G ER L Z DH AH
MEANTTRUTH	M EH N T R UW TH
SLEEK'T	S L IY K T
WINDOWS…	W IH N D OW Z
ALLGENTLE	AO L JH EH N T AH L
DOWNSKY	D AW N S K AY
HERELEANING	HH EH R AH L IY N AH NG
BOPPED	B AA P T
PÓTUIA	T UW AH
RONPADGETT	R AA N P AE JH AH T
BEAME	B AH EY M
PHILMEYORK	F IH L M EY AH R K
WHATWE	W AA T W
TSTOP	T S T AA P
AHMEDNAGAR	AH M EH D N AH JH AH R
MURED	M Y UH R D
DRIVED	D R AY V D
FLOSSES	F L AA S AH Z
TARDILY	T AA R D IY L IY
ASSCRACKS	AE S K R AE K S
KÁUNRESPECTED	K AH N R EH S EH K T AH D
SHEWED	SH UW D
BOOTETH	B UW T IH TH
NAMETHOUGH	N AE M AH TH UW
SCRATCHBURY	S K R AE CH B EH R IY
RUMI	R UW M IY
ENLIGHTNER	IH N L AY T N AH R
CONSIDERATELY	K AH N S IH D ER AH T L IY
LEOPARDI	L IY AH P AA R D IY
MYSELFINTO	M IH S AH L F IH N T OW
UTRILLO	AH T R IH L OW
DISHT	D IH SH T
THERMODON	TH AH R M AH D AH N
SLINGSBY	S L IH NG Z B AY
MONODATAL	M AA N OW D EY T AH L
LEWEDE	L UW IY D
TRABAJAR	T R AE B AH JH AH R
WINNOCKS	W IH N AH K S
ATUL	AE T AH L
EVERTHING	EH V ER TH IH NG
BARRENYOUR	B AE R EH N AY AH R
DEARIF	D IY AE R AH F
PARTSINTO	P AA R T S IH N T OW
MAGOG	M AE G AH G
CALVARYCEMETERY	K AE L V AH R IY S EH M AH T EH R IY
UNMOV	AH N M AA V
ARCHIPELAGOOF	AA R K AH P EH L AH G UW F
WASSAIL	W AH Z EY L
CONVEXED	K AA N V EH K S T
VIRENT	V AY R AH N T
CALIGINOUS	K AH L IH JH AH N AH S
TELEGRAPHIC	T EH L AH G R AE F IH K
REDAND	R AH D AE N D
VCR	V IY S IY R
TREMBLER	T R EH M B AH L ER
PAROUSIA	P AH R AW ZH IY AH
DAISHI	D EY SH IY
MÉNAGE	M N EY JH
DIPHTHONGS	D IH F TH AH NG Z
'NO	N OW
GHASTLIEST	G AE S T L IY AH S T
BALMIE	B AA M IY
WATCHBY	W AA CH B AY
OVERLONG	OW V ER L AO NG
BOILSWITH	B OY L Z W IH TH
REMORANTE	R AH M AO R AH N T
CREVICING	K R EH V AH S IH NG
FISHNET	F IH SH N EH T
CEPHALUS	S EH F AH L AH S
STEERAGE	S T IH ER IH JH
HYA	HH AY AH
DALMATION	D AH M EY SH AH N
WINDOWPUTS	W IH N D OW P UH T S
OCCURED	AH K ER D
LAUGHÈN	L AO N
DARK'NING	D AA R K N AH NG
SNARK	S N AA R K
BUSINESSON	B IH Z N AH S AO N
GREMIUM	G R IY M IY AH M
MOMENTOF	M AH M EH N T AH F
SAAID	S AA AH D
GALLILEAN	G AE L AH L AH N
RIVERBOATIS	R IH V ER B OW T IY Z
WALLOONS	W AA L UW N Z
INCLUDEEXTRACTS	IH N K L UW D IH K S T R AE K T S
BLUEBELLSAND	B L UW B EH L S AE N D
SCARABIES	S K AA R AH B AY Z
UNTRI	AH N T R IY
TAMARISKWHOSE	T AH M AE R AH S W HH OW Z
WALLTO	W AA L T OW
BABITONIGHTTHE	B AH B IH T AH N AY T DH
OFPAINT	AA F EY N T
SALTLAND	S AO L T L AE N D
HUNDER	HH AH N D AH R
CF	S IY F
TEJEND	T EH JH AH N D
GIVE/	G IH V
TALIESSIN	T EY L IY AH S IH N
TIMESWHEN	T AH M EH S W AH N
LONGESTOF	L AA N JH EH S T AH F
ZATARI	Z AE T AH R IY
DO'ANT	D UW Z AH N T
COWTO	K OW W T OW
GOLDENGROVE	G OW L D AH N G R OW V
VENUSIANS	V EH N Y UW S IY AH N Z
3/	TH R IY
ENJAMBED	EH N JH AE M B EH D
VESPAS	V EH S AH Z
IAY	AY EY IY
FORWAS	F AO R W AH Z
KICKFLIP	K IH K F L IH P
GAFFED	G AE F T
PARSNIPS	P AA R S N IH P S
OKANOTHERPLACE	AH K AE N AH TH AH R P L AH S
VOUT	V AW T
RAINLESS	R EY N L AH S
MONS	M AA N Z
WHICHYOU	W IH CH AY UW
PASSUNDER	P AE S AH N D ER
DRUGGET	D R AH G EH T
SLIPSYOU	S L IH P S AY UW
CEREUS	S IH R IY AH S
GIVENWAS	JH AH V EH N W AH Z
WITCHLIKE	W IH CH L AY K
GRAWS	G R AO Z
FORMERHIDDEN	F AO R M ER HH IH D AH N
SLEEPFILLS	S L IY P F IH L Z
UPMOUNTING	AH P M AW N T IH NG
STRAITN	S T R EY T N
MASTER/SLAVE	M AE S T ER S L EY V
LAUGHES	L AO Z
ALONGEACH	AE L AH N JH IY CH
TINCT	T IH NG K T
GOWNSBURIED	G AW N Z B EH R IY D
DUDENESS	D AH D AH N AH S
UNTHREADING	AH N TH R EH D IH NG
ENRANGED	EH N R EY N JH D
STAMMERED	S T AE M ER D
ELECTRONBLACK	IH L EH K T R AA N B L AE K
GEMLIKE	JH EH M L AY K
HEPHAESTUS	HH EH F EY EH S T AH S
PIMPED	P IH M P T
BLADDERED	B L AE D ER D
CHIAN	CH AY AH N
WITTICISMS	W IH T IH K S IH Z AH M Z
MIDDAGH	M IH D AH
ARROWWOOD	AE R OW W UH D
GENTLEMANLIKE	JH EH N T AH L M AE N L AY K
FASTORUM	F AE S T AH R AH M
SAVARIN	S EY V ER IH N
KNOBBES	N AA B IY Z
PRECIPICES	P R EH S AH P AH S IH Z
TICAL	T AY K AH L
BRIMMIN	B R IH M AH N
2036	T UW Z IY R OW TH R IY S IH K S
VOICEMILDE	V OY S AH M AH L D
LORDLIER	L AO R D L IY ER
THEYSAY	TH EY S EY IY
INSCRIB	IH N Z K R IH B
SCHEMETHESE	S K EH M AH TH IY Z
LASHRA	L AE SH R AH
NONDUM	N AA N D AH M
BETOKENED	B IH T OW K AH N D
RULELESSNESS	R UW L AH S N AH S
ANOTHERWHICH	AE N AH TH AH R W HH AH CH
KENS	K EH N Z
BREADCRUMBS	B R EH D K R AH M Z
WORLDBUBBLE	W ER L D B AH B AH L
DITTOS	D IH T AH Z
CONDENSERY	K AH N D EH N S AH R IY
THEMAGAIN	TH EH M AH G EY N
IMAGIST	IH M EY JH IH S T
DOOMES	D UW M Z
FINGERSTHE	F IH N JH AH R S DH
THEYCALMED	TH EY K AH M D
DEAWY	D IY AO IY
HAKAGAWA	HH AH K AE G AH AH
YOGHURT	Y AA AH R T
CHYLÁBBORAK	CH IH L B AH R AH K
FEROOD	F AH R UW D
WYNNYNG	W IH N AH NG
STABB	S T AE B
MAIST	M EY AH S T
CANARIES…	K EY N EH R IY Z
ABRUPTION	AH B R AH P SH AH N
BARDOT	B AA R D AA T
SCHISMATICS	S K IH Z AH M AH T IH K S
REMONSTRATE	R IH M AA N S T R AH T
LISMAGUNSHIN	L IH Z M AH G AH N SH AH N
FROWZY	F R AW Z IY
WOULDBEST	W OW L D AH S T
GLASSI	G L AE S IY
CHRISTHOOD	K R IH S T UH D
ENUMERATING	IH N UW M ER EY T IH NG
AMPLITUDES	AE M P L AH T UW D Z
FLEXOR	F L EH K S ER
GABIROL	G AE B AH R AH L
RUINAND	R UW N AH N D
KYRTLE	K AH R T AH L
OFHERCULES	AA F AH R K Y UW L Z
ENTHRALMENT	IH N TH R AO L M AH N T
BEWEEP	B IH W IY P
MADTOWNS	M AE D T AW N Z
COPULATION	K AA P Y AH L EY SH AH N
CHÉAD	CH AE D
CUANDO	K Y UW AE N D OW
KFORSOOTH	K F AO R S UW TH
NAGAMOWINAN	N AE G AH M OW AH N AH N
DUMBNESS	D AH M N AH S
VOUTSAFE	V AW T S EY F
PULVERIZING	P AH L V AH R AY Z IH NG
YOURSYMPHONY	Y AH R S IH M F AH N IY
NUMMED	N AH M D
SUPERSTITIONAND	S UW P AH R S T AH T IY AH N AH N D
HESPERIA	HH EH S IY R IY AH
UPTORE	AH P T OW R
FEMOLE	F AH M OW L
MOONCUT	M UW N K AH T
CONSTER	K AA N S T ER
A2	EY T UW
HOMETOWN/	HH OW M T AW N
ASKHER	AE S AH R
LIKEA	L IH K IY AH
FATALE	F AE T EY L
DANDLED	D AE N D AH L D
ORGIASTICLY	AO R JH IY AE S T IH K L IY
BLOODPRESSURE	B L AH D P R EH SH ER
KAMABOKO	K AH M AE B AH K OW
POLYSEMOUS	P AH L IH S AH M AH S
FLEDST	F L EH D S T
SIÈCLE	S AY K AH L
OVERNIGHTEDIN	OW V ER N AY T EH D IH N
CHILDSWORTH	CH AY L D Z W ER TH
RETINAS	R EH T AH N AH Z
SCORCHEDYOUR	S K AO R CH EH D AY AH R
1389	W AH N TH R IY EY T N AY N
16:14	W AH N S IH K S W AH N F OW R
HEDDLE	HH EH D AH L
FENTANYL	F EH N T AH N AH L
FOXED	F AA K S T
ATOMIZERS	AE T AH M AY Z ER Z
WISA	W IH S AH
INFRANGIBLY	IH N F R AE N JH IH B L IY
BROGHTE	B R AA T
DAYLILIES	D EY L IY L IY Z
MUCHI	M AH CH IY
SUGARCOATED	SH UH G ER K OW T IH D
OTHERSALREADY	AH DH ER Z AH L R EH D IY
UNGARLANDED	AH N G AA R L AH N D IH D
EIDER	IY D AH R
ISSU	IH S UW
NS	EH N S
MANYOU	M AE N AY UW
HITHERAO	HH AH TH EH R EY OW
JERROD	JH EH R AH D
INIQUITATEM	AH N IH K W IH T AH T AH M
CLACKETY	K L AE K AH T IY
BEACE	B IH EY S
COMMUNI	K AA M Y UW N IY
IMAGISTS	IH M EY JH IH S T S
DOTHE	D OW DH
ARTIFI	AA R T AH F IY
ANGELOF	AE N JH AH L AH F
SUMMOND	S AH M AH N D
TRANSBAY	T R AE N S B EY
COCKIT	K AA K IH T
CRUSTING	K R AH S T IH NG
BANISHES	B AE N IH SH IH Z
MYSELFWHAT	M AH S EH L F W HH AH T
FÆCULENCE	F K Y UW L AH N S
SCUDDED	S K AH D IH D
EVENING–	IY V N IH NG
FRYDAY	F R AY D EY
THROATSINTO	TH R OW T S IH N T OW
BLAMM	B L AE M
OBTRUSIONS	AH B T R UW ZH AH N Z
PIKEMEN	P AY K M EH N
OUTSHINEDAUGHTERS	AW T SH AY N D AO T ER Z
TOGRAPHS	T AA G R AH F S
UNLAP	AH N L AE P
SAUNTERING	S AO N T IY R AH NG
HEOR	HH IY AH R
DEADWHATEVER	D IY AE D W HH AH T IY V AH R
CONVOLUTIONS	K AA N V AH L UW SH AH N Z
OURSI	AH R S IY
MOONPOISON	M UW N P OY Z AH N
OUTLIVERS	AW T L IH V ER Z
SOLSTICEBLESSED	S AA L S T AH S B L EH S T
SUBMARINEWHICH	S AH B M AE R AH N Y UW HH AH CH
ORATORIES	AO R AH T OW R IY Z
SOOTE	S UW T
RUSHLIKE	R AH SH L AY K
GLAZ	G L AE Z
CONTIGUITY	K AA N T IH G Y UW AH T IY
RAPEFLOWERS	R EY P F L AW ER Z
SWEETSIN	S W IY T S IH N
DREAMLESS	D R IY M L AH S
AYLELOLAY	EY L AH L AA L EY IY
MARMOT	M AA R M AH T
TUBERS	T UW B ER Z
EMPIRIE	EH M P AY ER IY
BATHYPELAGIC	B AH TH IH P AH L AH JH AH K
NOS	N OW Z
RECALLWHO	R AH K AE L W HH OW
OFFSPRINGWITH	AO F S P R IH NG W IH TH
SESSIOUNS	S EH S IY AW N Z
CREMAINS	K R AH M EY N Z
PESTEREV	P EH S T AH R AH V
BLESSE	B L EH S
HINKY	HH IH NG K IY
TOWELED	T AW AH L D
IMPALPABLE	IH M P AE L P AH B AH L
TENSES	T EH N S IH Z
TATTERING	T AE T ER IH NG
SWIN	S W IH N
THOUGHTIT	TH AO T AH T
BIRDSEXCEPT	B ER D Z IH K S EH P T
DESCENDSAND	D IH S EH N D S AE N D
22/	T UW T UW
COLLOQUIESEN	K AA L AH K W IY Z AH N
HOWLERS	HH AW L ER Z
WUZ	W AH Z
COOLAFTER	K UW L AE F T ER
LINTELS	L IH N T AH L Z
MILKWATER	M IH L K W AO T ER
DISUS	D AY Z AH S
BANKWHERE	B AE NG K W HH AH R
BEPAINTED	B IH P EY N T IH D
TIGHTWHEN	T AY T W AH N
AFFECTED…	AH F EH K T IH D
FRAMEDTHAT	F R AH M EH D TH AH T
FOLDINGS	F OW L D IH NG Z
TEARFROM	T AH R F R AH M
PROCURES	P R OW K Y UH R Z
BAFFLEMUTE	B AE F AH L M Y UW T
MENTORCITO	M EH N T AO R S AH T OW
CANOPYTHAT	K AH N AA P AH TH AH T
VITIOUS	V IH SH AH S
LEÄNÈN	L EH N
AITCH	AH IH CH
RECTIUS	R IH K T AY AH S
ATTENDA	AE T EH N D AH
FROMHOME	F R AA M HH OW M
SNAKEROOT	S N EY K R UW T
NUF	N AH F
COUNTREY	K OW AH N T R IY
PECKT	P EH K T
ENFOLDS	EH N F OW L D Z
QUINNETS	K W IH N AH T S
TRAINSIGHS	T R EY N S AY Z
POSHEST	P AA SH AH S T
GISTS	JH IH S T S
CABRANEZ	K AE B R AH N AH Z
DITFLAUBERT	D IH T L AH B AH R T
EMPORIO	IH M P AO R IY OW
CULINARYEMBODIMENT	K Y UW L AH N AE R AY EH M B AA D AH M AH N T
REVELATOR	R EH V AH L AH T ER
UNTYING	AH N T AY IH NG
JETZT	JH EH T S T
SHITLESS	SH IH T L AH S
FUERTES	F Y UW AH R T S
PISSY	P IH S IY
LOV	L AA V
TRUSTMY	T R AH S T M IY
MUGOO	M Y UW G UW
SUICIDEI	S UW S AH D IY
BACKIN	B AE K IH N
CLASSISM	K L AE S IH Z AH M
PLIANTLY	P L AY AH N T L IY
UNINNOCENT	AH N IH N AH S AH N T
COODER	K OW OW D AH R
SEDGED	S EH JH D
BELLSOF	B IH L S AA F
DISSENTMARKS	D IH S EH N T M AA R K S
BLUNDERERS	B L AH N D ER ER Z
DOUBTEDBUT	D AW B T EH D AH T
RICHTERS	R IH CH T AH R Z
MAGNETIZES	M AE G N AH T AY Z IH Z
FICE	F AY S
SHOWERSALL	SH AW ER Z AO L
TTL	T IY T IY L
WINESKIN	W AY N S K IH N
TOYSAROUND	T OY Z AH R AW N D
CRAFTINESS	K R AE F T IY N AH S
240,000	T UW F OW R Z IY R OW Z IY R OW Z IY R OW Z IY R OW
PEYNED	P EY N D
MARTINEZPILLOW	M AA R T AH N AH Z P IH L OW
BLASPHEMIES	B L AE S F AH M IY Z
OFFRAMP	AO F R AE M P
FLESHES	F L EH SH IH Z
SCARLOT	S K AA R L AA T
SULPHURIC	S AH L F ER IH K
DRÉAM	D R AE M
UPRAISED	AH P R EY Z D
NAMDE	N AE M D
SCHISMATIC	S K IH Z AH M AH T IH K
MAITREYA	M EY T R EY AH
WANDERNIGHTS	W AA N D ER N AY T S
SHADOWAND	SH AE D OW AH N D
YAYOI	Y EY OY
ITNOT	IH T N AH T
NIGHTMAR	N AY T M AA R
HOSTA	HH AA S T AH
BROILLE	B R OY L
MUCKS	M AH K S
HÜRTGEN	HH R T JH EH N
MERRILYN	M EH R AH L AH N
THITHERINGS	TH IH DH ER IH NG Z
HUGSLAISSEZ	HH AH G S L EY S AH Z
BLK	B IY EH L K
SOTHE	S OW DH
DEARIES	D IH ER IY Z
FROMAGE	F R OW M AH JH
BURQAS	B AH R K AH Z
DISTAFF	D IH S T AE F
FAMOUSED	F EY M AH S T
PUBLICANS	P AH B L AH K AH N Z
VERITABLENIGHT	V EH R AH T AH B AH L N AY T
TITTLETO	T IH T L AH T OW
MORNIN	M AO R N AH N
STARBLACK	S T AA R B L AE K
ALWEY	AE L W IY
MORNINGRISE	M AO R N IH NG R AY Z
FAITHTHAT	F EY TH AH T
COLOROF	K OW L AO R AH F
PRACTISETH	P R AE K T AH S IH TH
BICHO	B AY CH OW
SSH	EH S EH S
ULSTERMAN	AH L S T AH R M AH N
TRANSGREST	T R AE N S G R AH S T
SPARKLINGAS	S P AA R K L IH N G AH Z
JAV'LIN	JH AE V L AH N
CONCEPTION–AT	K AA N S EH P T IY AH N AH T
BEAKERS	B IY K ER Z
DALLION	D AE L IY AH N
MALENESS	M EY L N AH S
NIGHTWOOD	N AY T W UH D
HOUSES…	HH AW S IH Z
PRAXITELEAN	P R AE K S AH T IY L IY AH N
VERTICALS	V ER T IH K AH L Z
CHASMED	K AE Z AH M D
DÜBANLIEUES	D B AE N L Y UW Z
LOFTING	L AO F T IH NG
ORMOC	AO R M AH K
BLOODROOT	B L AH D R UW T
HOWWE	HH OW W
SWOUNDE	S W AW N D
POURLIEUES	P AH R L Y UW Z
TUBERCLE	T Y UW B AH R K AH L
COURAGEEVEN	K ER IH JH IY V AH N
EAGLETS	IY G L AH T S
612	S IH K S W AH N T UW
EYEA	EY IY AH
SLOWI	S L OW IY
MATINSMATINS	M AE T AH N Z M AE T AH N Z
GENERALLIVABLE	JH EH N ER AH L IH V AH B AH L
REBEC	R AH B EH K
INEXTINGUISHABLE	IH N IH K S T IH NG G W IH SH AH B AH L
FOWLS	F AW L Z
POQUITO	P AA K W AH T OW
CONSORTED	K AA N S AO R T IH D
AETHIOPICUS	AH TH IY AH P IH S AH S
CARDERS	K AA R D ER Z
UNCOMPASSIONATE	AH N K AH M P AE SH AH N AH T
SCHOOLAS	S K UW L AH Z
UNGIRDED	AH N G ER D IH D
QUYCKE	K W IH K
OBIS	OW B AH S
INEVITABLEFUCKING	IH N EH V AH T AH B AH L F AH K IH NG
DAUGHTERA	D AO T AH R AH
–'YOU	AY UW
MUSITS	M Y UW S AH T S
NOEXPLANATION	N OW EH K S L AH N EY SH AH N
MEANSTO	M IY N S T OW
WOMANOR	W UH M AH N ER
SOFTNESSES	S AO F T N AH S IH Z
FAERY	F AE ER IY
DEZ	D EH Z
NOVELIZE	N AA V AH L AY Z
GEODON	JH IY AH D AH N
WINDHEADS	W IH N D HH EH D Z
UNLEARN	AH N L ER N
TRADUCTION	T R AH D AH K AH N
SWELLFOOT	S W EH L F UH T
BLYNKEN	B L IH NG K AH N
STOTE	S T OW T
REGIONTHAT	R AH JH AY AA N TH AH T
TRAGEEDY	T R EY JH IY D IY
SISTERS/	S IH S T ER Z
ENCOURAG	IH N K AH Y UH R AH G
SOLIPSISM	S AA L AH P S IH Z AH M
LABOROF	L AE B AH R AH F
LOGSNO	L AA G S N OW
SNAZZIEST	S N AE Z IY AH S T
REMEMBERSO	R AH M EH M B AH R S OW
AKHMATOVA	AE K M AE T AH V AH
MARMOSETS	M AA R M AH S AH T S
MINORBIRDS	M AY N ER B ER D Z
AGEINE	EY JH IY N
BODYIS	B AA D IY IY Z
SHOWES	SH OW Z
LUGDUNUM	L AH G D Y UW N AH M
FINGERSTO	F IH N JH AH R S T OW
NEOLITHIC	N IY OW L AY DH IH K
BLASCHKA	B L AE S AH
REAKING	R IY AH K IH NG
SPINET	S P IH N AH T
CHAIRSRISING	CH EH ER Z R IY Z IH NG
FROLICKED	F R AA L IH K T
EMOLLIENT	AH M AA L IY AH N T
UNCONQUERABLE	AH N K AA NG K ER AH B AH L
NODDINGOFF	N AA D IH NG AO F
CLOBBERS	K L AA B ER Z
SUDSY	S AH D Z IY
UNAVAILINGLY	AH N AH V EY L IH NG L IY
PULSATE	P AH L S AH T
SULTRINESS	S AH L T R IY N AH S
CRAPES	K R EY P S
BUMBERSHOOTIN	B AH M B IY ER SH UW T IH N
ACCEPTATION	AE K S EH P T EY SH AH N
FYRSTE	F AH R S T
CAPERINGON	K EY P R IH NG AO N
ITAGAIN	IH T AH G EY N
YOUCONCENTRATING	Y AW K AA N S AH N T R EY T AH NG
LORQUIN	L AO R K W AH N
GRASA	G R AE S AH
ANTIPODEAN	AE N T AH P OW D IY AH N
KEPLER…	K EH P L AH R
FOOGAS	F UW G AH Z
ITALY/	IH T AH L IY
DTABHARFAÍTHE	D T AE B HH AH R F EY DH
MESSENGERSREVEAL	M EH S AH N JH ER Z R IH V IY L
GREATDESIGN	G R EY T D IH Z AY N
DRYAD	D R AY AH D
WHOKEEP	W OW K IY P
EARTHFIRST	ER TH F ER S T
TO…	T UW
SWEENEYS	S W IY N EY Z
MARYBON	M AE R AH B AH N
'SCAP	S K AE P
EDIKASHUN	AH D IH K AH SH AH N
HUMANSCAPE	HH Y UW M AH N S K EY P
SAYWHAT	S EY W HH AH T
NEEDST	N IY D S T
THEMOF	TH EH M AH F
ENTERD	IH N T AH R D
FRIGHTING	F R AY T IH NG
ALTAMA	AE L T AH M AH
BRIGADA	B R IH G AH D AH
UNCOMMENDED	AH N K AH M EH N D IH D
BLANNWENT	B L AE N W AH N T
MAJORTO	M AH JH AO R T OW
EARTHSHOUTS	ER TH SH AW T S
PANOPLIES	P AH N AA P L AY Z
EMPTYNOSESYNDROME	EH M P T IY N OW Z S IH N D R OW M
SAMEWHITE	S EY M W AY T
BEAUTIFULWHEN	B AH AO T AH F AH L W AH N
REYKJAVÍK	R IY Y K JH AE V K
PASTUR	P AE S T AH R
UNRUMPLES	AH N R AH M P AH L Z
OUIJA	AW AH JH AH
REVENANT	R EH V AH N AH N T
GOATHERD	G OW T HH ER D
CHANKLY	CH AE NG K L IY
IMPERIO	IH M P AH R AY OW
UNDERSTANDSEVERY	AH N D ER S T AE N D S AH V IH ER IY
PLUMING	P L UW M IH NG
SUNPLEASANT	S AH N P L EH Z AH N T
JUGLING	JH AH G L IH NG
LONDINIUM	L AA N D IH N IY AH M
BLACKFELLAS	B L AE K EH L AH Z
SECURI	S EH K Y AH R IY
SERVEN	S ER V AH N
TRAINËD	T R EY N D
UNRIGHTEOUS	AH N R AY CH AH S
PLUMAS	P L UW M AH Z
PRECISERESPONSE	P R IH S AY S R IH S P AA N S
SQUISHING	S K W IH SH AH NG
POLEMONIUM	P AA L AH M OW N IY AH M
RINKSAYS	R IH NG K S EY Z
DEEGHTED	D IY EH T AH D
INTROVERTS	IH N T R AH V ER T S
UNSELF	AH N S EH L F
GIGANTEUS	JH AH G AE N T IY AH S
COUTH	K OW AH TH
DOUANE	D AW EY N
PINKES	P IH NG K S
PITTSBURGH–ONCE	P IH T S B AH R AH N S
FATWOOD	F AE T W UH D
HARBOURAGE	HH AA R B OW Y AH R AH JH
LACEDWITH	L EY S T W IH TH
8AMOR	EY T EY EH M OW AA R
HUSHPUPPY	HH AH SH P AH P IY
MAMSELLES	M AE M Z AH L Z
FAGGOTS	F AE G AH T S
CAVORTS	K AH V AO R T S
EUTERPE	Y UW T AH R P
UNCONTENT	AH N K AH N T EH N T
FCITYWITH	F S IH T AH W AH TH
ILYATS	IH L AY EY T S
LETHARGICALLY	L AH TH AA R JH AH K AE L IY
TOMILFORD	T AA M IH L F OW R D
CURIOUSALL	K Y UH R IY AH S AO L
'ALLOWANCE	AE L OW AH N S
BASSOONS	B AE S OW AO N Z
BRUKHAHS	B R AH K AH Z
RYDE	R AY D
BELLYFUL	B EH L IY F AH L
RUNI	R UW N IY
TERRIFYINGIN	T EH R AH F AY IH N JH IH N
FUDGSICLE	F AH JH S AH K AH L
THEOS	TH IY AH Z
MOSTJUST	M OW S T JH AH S T
TOEIN	T OW IH N
DEADEST	D EH D AH S T
RUGATE	R AH G AH T
1998	W AH N AY N AY N EY T
STREETSIGN	S T R IY T S AY N
EYELINE	AY L AY N
WAXPAPER	W AE K S P EY P ER
SENTERIES	S EH N T AH R IY Z
WASHTUBS	W AA SH T AH B Z
STRETCHT	S T R EH CH T
INCHOATE	IH N CH OW EY T
COFFEECUPS	K AO F IY K AH P S
STRIFESOUGHT	S T R AY F S AO T
DRUMSWITHOUT	D R AH M Z W IH TH AW T
HOMONCULUS	HH AH M AO NG K Y AH L AH S
LOWERINGTO	L OW AH R IH N G T OW
HEREASLEEP	HH IY R IY Z L IY P
SOLUTE	S AA L Y UW T
BETWEENWE	B IH T W IY N W
HELPSPILLING	HH EH L P S P IH L IH NG
ZOOABET	Z UW AH B EH T
JACARANDA	JH AE K AH R AE N D AH
STRUGGLETO	S T R AH G L AH T OW
UNDERBELLIES	AH N D ER B EH L IY Z
FLIP/EITHER	F L IH P IY DH ER
SWYNKE	S W IH NG K
INKING	IH N K IH NG
SANDPLAY	S AE N D P L EY
ROUSHDY	R AW SH D IY
RIMINI	R IH M AH N IY
DIAGNOSTICIAN	D AY IH G N AA S T IH SH AH N
PROFFER'D	P R AA F ER D
UNBODIED	AH N B AA D IY D
REMORSEAND	R AH M AO R S IY N D
UNIVERSETHAT	Y UW N AH V AH R S AH TH AH T
ANVILS	AE N V AH L Z
LIVERIES	L IH V R IY Z
GIRLSGET	G ER L Z G EH T
ONUNTIL	AH N AH N T AH L
TEXTAND	T EH K S T AH N D
EVENNATURAL	IY V AH N AH CH ER AH L
BLOWSA	B L OW S AH
YEARSAGO	Y IH ER S EY G OW
BUÑUELOS	B Y UW AH AH L AH Z
METAMORPHOSES	M EH T AH M AO R F OW Z IH Z
FIXE	F IH K S
LISSADELL	L IH S AH D AH L
KISHINEV	K IH SH AH N AH V
SENECIO	S AH N IY S IY OW
TIDORE	T IH D AH R
TREESIN	T R IY S IH N
BOLSHEVIKI…	B OW L SH EH V AH K IY
IT–TO	IH T OW
CATALPAS	K AH T AE L P AH Z
PETALSCRISP	P EH T AH L Z K R IH S P
BAVIUS	B AE V AY AH S
MELÉNDEZ	M EH L N D AH Z
BLADDERWRACK	B L AE D ER R AE K
DROOPINGS	D R UW P IH NG Z
BUNSEN	B AH N S EH N
SHARKY	SH AA R K IY
CAPTIOUS	K AE P SH AH S
DISEMBOWELING	D IH S IH M B AW AH L IH NG
CLOYSTRE	K L OY S T AH R
CACOPHONIES	K AE K AA F AH N IY Z
KUH	K UW
YIELDA	Y IY L D AH
DREADLOCKS	D R EH D L AA K S
BALLYVAUGHAN	B AE L IH V AH AH N
KEEPE	K IY P
HADGREEN	HH AE JH R IY AH N
¡HIJO	HH IH JH OW
SIGNSWITHOUT	S AY N Z W IH TH AW T
FIDG	F IH JH
ANGERAS	AE N JH AH R AH Z
DUSTYPROTECTIVE	D AH S T IY P R AH T EH K T IH V
COWWITH	K AW IY TH
DREARISOME	D R IH ER IY S AH M
CYCLONIC	S IH K L AH N AH K
FAIRYLANDS	F AE ER IY L AE N D Z
JANÁACCUSATIONALWAYS	JH AH N AH K Y AH S AH T IY AH N AE L W EY Z
THATAWAY	TH AH T AO EY IY
KAPITAL	K AE P AH T AH L
YOUV	Y AW V
DNAGRA	D N AE G R AH
QUIÚ	K W IY
CRUSHEDFLOWING	K R AH SH T F L OW IH NG
OPENMOUTHED	OW P AH N M AW TH T
ORGANWORKS	AO R G AH N W ER K S
O'ERTURN	AH AH R T AH R N
RETURNERS	R IY T ER N ER Z
ISMY	IH Z M IY
FASTENETH	F AE S AH N IH TH
CREDESSE	K R EH D AH S
DISPARITIE	D IH S AE R AH T AY
SENNACHERIB	S EH N AE CH AH R AH B
DEPENDABLY	D IY P EH N D AE B L IY
SEEERINGO	S IY ER IH N G OW
CAIREN	K AE AH R AH N
DÉESSE	D IH S IY
YOUHOLD	Y AW HH OW L D
IFICE	AY F AH S
DAIKICHI	D EY K AH CH IY
FRAILE	F R EY AH L
PLACENONE	P L AE S AH N OW N
FAILUREFOR	F EY L Y ER F AO R
SHEENÈN	SH IY N
CIPHERED	S AY F ER D
UNCLOSE	AH N K L OW Z
CORYPHODON	K OW R IH F AH D AH N
HAVINGA	HH AH V IH N G AH
SACRILEDGE	S AE K R AH L AH JH
TEAMCLOSER	T IY M K L OW Z ER
QUARKED	K W AO R K T
HUNDERD	HH AH N D AH R D
CONGEALS	K AH N JH IY L Z
UNWARM	AH N W AO R M
PAPILLON	P AE P IH L AO N
MONTASHIGI	M AA N T AE SH AH JH IY
OWLET	OW L AH T
OLDOR	OW L D ER
XBADWANT	Z B AE D W AH N T
MIMEO	M IH M IY OW
SINGIN	S IH N JH IH N
ASTORY	AH S T OW R IY
UNDERSHORTS	AH N D ER SH AO R T S
ASSUAGES	AH S W EY JH IH Z
CHERUBICK	CH AH R UW B AH K
ITERATE	IH T ER AH T
PRIMEFLOWN	P R AY M F L OW N
BLOOMINGS	B L UW M IH NG Z
HELPIS	HH EH L P IY Z
BASSMAKER	B EY S M EY K ER
BUFFALOED	B AH F AH L OW D
LOCKBOXES	L AA K B AA K S IH Z
SEAVENTIMES	S IY V AH N T AY M Z
IOLAUSWAS	AY AH L AO S W AH Z
ELEALE	IY L IY L
DARKNES	D AA R K N Z
PINNATE	P IH N AH T
NODDLE	N AA D AH L
IBEQ	IH B AH K
SPICK	S P IH K
AESTHETICIAN	EH S TH AH T IH S IY AH N
PASSEST	P AE S AH S T
DISTURBDTHIS	D IH S T AH R B D TH AH S
STICHES	S T IH CH AH Z
HOLDOF	HH OW L D AH F
WEAPONLESS	W EH P AH N L AH S
DEATHWARD	D EH TH W ER D
ANIMALCRUDE	AE N AH M AH L K R UW D
TARANAKI	T AH R AE N AH K IY
ESCAPETH	IH S K EY P IH TH
STRAIGHTWAY	S T R EY T W EY
SMOLDERS	S M OW L D ER Z
RIBALDS	R IH B AH L D Z
DÉEPER	D IY P AH R
NEEDLEPLOUGHS	N IY D L EH P L AW Z
OMEROS	AA M AH R AH Z
1767	W AH N S EH V AH N S IH K S EH V AH N
PRUDENTIUS	P R UW D EH N T AY AH S
'LLOW	L OW
BUU	B Y UW AH
IMAGINO	AH M AE JH AH N OW
FINGERSOF	F IH N JH AH R S AH F
WHEELD	W IY L D
SCARSFROM	S K AA R S R AH M
PURGATION	P ER G EY SH AH N
RESTEVEN	R EH S T IY V AH N
EMANCIPATORY	IH M AE N S AH P EY T ER IY
MASTURBATOR	M AE S T AH R B EY T AH R
TAMELY	T EY M L IY
PITTYING	P IH T IY IH NG
TRING	T R IH NG
RRAIZED	R EY AY Z D
BROKENTHAT	B R OW K AH N T HH AE T
HOMOSEXUALISTS	HH OW M OW S EH K SH AH W AH L IH S T S
SUBDEWD	S AH B D Y UW D
WORECHUCK	W OW R CH AH K
53RD	F AY V TH R IY AA R D IY
'UD	AH D
SLOWWORM	S L OW W ER M
SONRÍE	S OW N AH R
THERWITH	TH AH R W AH TH
SOYPORK	S OY P OW R K
ZVAK	Z V AE K
JAHANGIR	JH AH HH AE N JH AH R
TROPISM	T R OW P AH Z AH M
UNAGEING	AH N EY JH IH NG
MOTHERTRIES	M AH DH ER T R AY Z
WALKEDSO	W AA L K EH D S OW
HEARAROUND	HH IH ER AH R AW N D
LARYNGITIC	L AH R IH N JH AH T AH K
BLAZONS	B L EY Z AH N Z
DESOTA	D AH S OW T AH
COASTALBARRENS	K OW S T AH L B AE R AH N Z
SPACEDOZER	S P EY S D OW Z ER
THEMCLIMBING	TH EH M K L IH M AH NG
INCORONATA	IH N K AH R AA N AH T AH
16,000,000	W AH N S IH K S Z IY R OW Z IY R OW Z IY R OW Z IY R OW Z IY R OW Z IY R OW
DOMEOF	D OW M IY AH F
TREADMIRE	T R IY D M AY R
NECTARS	N EH K T ER Z
SELFISHLY	S EH L F IH SH L IY
SUBMITSTO	S AH B M IH T S T OW
MAÎTRE	M EY T AH R
BANNS	B AE N Z
THEPLAN	TH EH P L AH N
OFBLACK	AA F B L AH K
UNBUDDED	AH N B AH D IH D
BEJESUS	B IY JH AH Z AH S
MANHEADBUTTING	M AE N HH EH D B AH T IH NG
XTHA	Z TH AA
FLUTT'RING	F L AH T R AH NG
FRENZYTHE	F R EH N Z AH DH
SEEDFROM	S IY D F R AH M
BISYNESSE	B AY S IH N AH S
GRAFTINGS	G R AE F T IH NG Z
WATCHEDWAR	W AA CH T W AO R
PATET	P AE T AH T
REVOLV	R AH V OW L V
DISCIPLIN	D IH S IH P L AH N
STREIDERS	S T R IY D AH R Z
REVELATIONTHAT	R AH V AH L EY T IY AA N TH AH T
TEMPRANA	T EH M P R AH N AH
ABOUTCONNECTING	AH B AW T K AH N EH K T IH NG
AMERIKANER	AH M EH R AH K EY N AH R
IDALIAN	AH D EY L IY AH N
JAND	JH AE N D
SAILCLOTH	S EY L K L AO TH
DRAINAGES	D R EY N IH JH IH Z
ALLDIRECTIONS	AO L D AH R EH K SH AH N Z
SHOOTETH	SH UW T IH TH
FORKLESS	F AO R K L AH S
BUCERUCE	B Y UW S AH R UW S
HERMENEUT	HH AH R M IY N IY AH T
INSIDERUM	IH N S AY D R AH M
AUDIOBOOKS	AO D IY OW B UH K S
SORTAIENT	S AO R T EY IY AH N T
HELPMEET	HH EH L P M IY T
REGALEDWITH	R IH G EY L D W IH TH
FELTTHE	F EH L T DH
WESTAND	W EH S T AH N D
VÉCU	V K UW
STINKIN	S T IH NG K IH N
SLIDDERY	S L IH D AH R IY
PLENTIFULL	P L EH N T AH F AH L
DERISIONBEHIND	D IH R IH ZH AH N B IY HH AY N D
WOREBLINDFOLDS	W OW R B L AY N D F OW L D Z
ÉPICERIE	P AH S IY R AY
HAD'ST	HH AE D S T
ORALS	AO R AH L Z
POV	P AA V
COLERIK	K OW L EH R AH K
ROQUEFORT	R AA K W AH F AH R T
FOSSICK	F AA S AH K
THOUGHTAND	TH AO T AH N D
SPARROWSSHIVER	S P AE R OW Z SH IH V ER
PHRENZIED	F R EH N Z AY D
LOOTEDFROM	L UW T EH D F R AH M
DIPAND	D IH P AH N D
EXTOLLHIM	IH K S T AA L HH AH M
WHETTETH	W EH T IH TH
NÈGRES	N G R Z
UTTEREDWORDS	AH T ER D W ER D Z
LITRO	L IH T R OW
SOLIDARNOSC	S AA L AH D AA R N AH S
DIR	D IH R
SIEGEFOR	S IY JH F AO R
WER'T	W EH R T
EVACUATES	IH V AE K Y AH W AH T S
KNOWNOT	N OW N AH T
FAUBOURG	F AH B OW R G
TANTE	T AE N T
FROMMY	F R AA M IY
THEREWERE	TH EH R UW AH R
MNOS	M N AA Z
CARRYIN	K AE R IY IH N
SIGNIFIER	S IH G N AH F AY ER
BYUNTIL	B AY AH N T AH L
MORTCLOTH	M AO R T K L AO TH
ISCURVACEOUS	AY Z K ER V EY SH AH S
TROYLAND	T R OY L AE N D
SOUTHMOST	S AW TH M OW S T
CLAWIS	K L AO IY Z
QUARTERED	K W AO R T ER D
PLANKED	P L AE NG K T
CRAPPED	K R AE P T
CHANTTO	CH AE N T OW
ÉTUDE	T Y UW D
TUNDRAS	T AH N D R AH Z
JOAQUÍN	JH OW K W N
MANGLER	M AE NG G AH L ER
CHINOS	CH IH N AA S
SPAYNE	S P EY N
SULFURS	S AH L F ER Z
LOBOTOMIZED	L OW B OW T OW M AY Z D
DEWHONEY	D UW HH AH N IY
BATTENS	B AE T AH N Z
LYED	L AY D
BEDTIMES	B EH D T AY M Z
INVOK	IH N V AA K
SOMEHOWSUSPENDEDFROM	S AH M AH HH AH S AH S AH N D EH D F R AH M
TARAKA	T AE R AH K AH
BARNBURNERS	B AA R N B ER N ER Z
BADTO	B AE D T OW
MEALSBUT	M EH L S B AH T
COCKSMAN	K AA K S M AE N
BORDERWHERE	B AO R D AH R W HH AH R
WATCHTOWERTHEY	W AA CH T OW AH R TH IY
WORDLESSHEAR	W ER D L EH S HH IH ER
DAHOMEY	D AH HH OW M IY
HORSEFOLK	HH AO R S F OW K
FLANKOF	F L AE NG K AH F
NETI	N EH T IY
BREDTH	B R EH D TH
MARINAPROCLAIME	M AH R AH N AE P R AH K L EY M
EMBLAZONING	IH M B L EY Z AH N IH NG
STRATION	S T R AE SH AH N
DOESKIN	D OW S K IH N
THOLING	TH OW L AH NG
OOZY	UW Z IY
PEACEFULLITTLE	P IY S F AH L IH T AH L
ACULTURADAS	AE K AH L T Y UH R AH D AH Z
RAYLED	R EY L EH D
BURNINGIN	B ER N IH N JH IH N
RIVERWHERE	R AH V AH R W HH AH R
WREATHED	R IY DH D
ATTACKOUR	AE T AE K AH R
KPETI	K P EH T IY
IMAGINEALL	IH M AE JH AH N AO L
BODDOM	B AA D
RAINSTILL	R EY N S T IH L
BOSUN	B AA S AH N
CHESSPLAYERS	CH EH S P L EY ER Z
NONOT	N AH N AA T
HAWKINS/	HH AO K IH N Z
UNDOON	AH N D UW AO N
AUK	AO K
HQ	EY CH K
DICEOF	D IH S IY AH F
FLOUND	F L AW N D
PROSERPINE	P R OW Z ER P AY N
RIVERI	R IH V AH R IY
AÏDA	AE D AH
SHADIE	SH EY D IY
WIRWHERE	W AH R W HH AH R
LOVERSPULLED	L AH V ER Z P UH L D
YARDTHE	Y AA R D
VALANCES	V EY L AH N S IH Z
SAYSOMETHING	S EY S AH M TH IH NG
LOZENGESOF	L AH Z EH N JH AH S AH F
KNOCKETH	N AA K IH TH
RUGBUT	R AH G AH T
237	T UW TH R IY S EH V AH N
PRIDEMY	P R IH D AH M IY
THOUGHTMY	TH AO T M IY
BEAUTYTO	B AH AO T AH T OW
SNOOD	S N UW D
SWAGGERED	S W AE G ER D
10MG	W AH N Z IY R OW EH M JH IY
BACKCOME	B AE K AH M
66	S IH K S IH K S
REPROVES	R IY P R UW V Z
BIRDWORK	B ER D W ER K
DISPATCHT	D IH S AE CH T
BODYSLAM	B AA D IY S L AE M
TARRIES	T AE R IY Z
ROOMA	R UW M AH
UNDERDEEPER	AH N D ER D IY P ER
TOGETHERHADN	T AH JH EH TH AH R AH D N
CONFEST	K AA N F AH S T
LIGHTSAS	L AY T S AH Z
HALOSWITHOUT	HH EY L OW Z W IH TH AW T
RIVOLETS	R IH V AH L AH T S
FYNGRES	F IH N G AH R Z
MIMEOGRAPHED	M IH M IY AA G R AH F T
AFRESHTO	AE F R EH SH T OW
WRATHFUL	R AE TH F AH L
SOMETHINGIN	S AH M TH IH NG IH N
GENTLYSLID	JH EH N T L IY S L IH D
DAIMEN	D EY M AH N
HILLINTO	HH IH L IH N T OW
CANNOTMUFFLE	K AE N AA T M AH F AH L
HOLSTEINS	HH OW L S T IY N Z
WAOH	W EY OW
PIPPING	P IH P IH NG
LOVETH	L AH V IH TH
LASIE	L AA Z IY
STROKINGS	S T R OW K IH NG Z
PYNING	P AY N AH NG
STARSTHROUGH	S T AA R Z TH R AH F
CONSISTORY	K AH N S IH S T ER IY
FRAMDE	F R AE M D
GEÄMES	JH IY M Z
STOBO	S T AA B OW
EVENFALL	IY V AH N F AO L
TORSELLING	T AO R S EH L AH NG
MEMORABLELEGS	M EH M ER AH B AH L EH G Z
LATHERERS	L AE DH ER ER Z
ROOMER	R UW M ER
THENMAYBE	TH EH N M EY B
ZIGARETTE	Z IH G AH R EH T
MOULTED	M OW L T AH D
FREETHINKING	F R IY TH IH NG K IH NG
PBS	P IY B IY S
OVERRIDESTHIS	OW V ER R AY D Z TH IY Z
BLACKAND	B L AE K AH N D
BETWEENGONE	B IH T W IY N G OW N
RESOUNDINGMEN	R IY S AW N D IH NG M EH N
SALTBOXES	S AO L T B AA K S IH Z
BEDTO	B IH D T OW
ADOREIS	AH D OW R IY Z
NORTHFOLK	N AO R TH F OW K
WORKS–I	W AH R K S IY
DUNCIAD	D AH N S IY AH D
STREWNPILES	S T R UW N P AY L Z
MEDICINED	M EH D AH S AH N D
CODEX	K OW D EH K S
4	F OW R
#	
INAMORATAS	AH N AH M AO R AH T AH Z
CALENDRICAL	K AH L EH N D R IH S AH L
GRAFFITO	G R AE F AH T OW
DEFECTIVES	D IY F EH K T IH V Z
RAINSLICKED	R EY N S L IH K T
HOLDWHICH	HH OW L D W HH AH CH
BEAUTYES	B IH AH T AY Z
BOSCAGE	B AA S AH JH
ROUSETHE	R AW S AH DH
SEYD	S EY D
MOUNTAINTOPBY	M AW N T AH N T AA P B AY
RAYLESS	R EY L AH S
NACARET	N AE K AH R AH T
CITALOPRAM	S IH T AH L AA P R AH M
CARRELS	K AE R AH L Z
FEATHERSLIKE	F EH DH ER Z L AY K
PERCUSSES	P ER K AH S IH Z
KEYNE	K EY N
APARTFROM	AH P AA R T R AH M
SHOALING	SH OW L IH NG
JAUNDIC	JH AO N D AH K
UNBRAIDHIMSELF	AH N B R EY D HH AH M S EH L F
DIDNA	D IH D N AH
FANTASTICFANTASTIC	F AE N T AE S T IH K F AE N T AE S T IH K
HOUSEBOY	HH AW S B OY
OTHERSAYING	AH DH ER S EY IH NG
PLUMAT	P L UW M AH T
GONENESS	G AO N AH S
TWEENE	T W IY N
FORG	F AO R G
PRUNËD	P R AH N D
DOG/	D AO G
TEASELSTO	T IY S EH L S T OW
113	W AH N W AH N TH R IY
1950	W AH N AY N F AY V Z IY R OW
SNOWSHOVEL	S N OW SH AH V AH L
BEATEST	B IY T AH S T
LEPT	L EH P T
YNOGH	Y N OW
LUSTRAL	L AH S T ER AH L
MINUTER	M IH N AH T ER
NANE	N EY N
HOPESAND	HH OW P S AE N D
PIERRES	P IY R Z
NUMERO	N Y UW M AH R OW
LOVEHUNG	L AH V HH AH NG
MALGAM	M AE L G AE M
KMINUSCULAR	K M AH N AH S Y AH L AH R
ELBURZ	EH L B AH R Z
PHOSGENE	F AA Z JH IY N
FOGSEEM	F AA G S IY M
CHEEBA	CH IY B AH
ECBATANA	EH K B AE T AH N AH
GUAON	G Y UW EY AH N
ALCATRAZIAN	AE L K AH T R EY Z IY AH N
DICTIONS	D IH K SH AH N Z
FLASHLAMPS	F L AE SH L AE M P S
SPACEBETWEEN	S P AE S AH B EH T W IY AH N
UNFACED	AH N F EY S T
OCCLUDED	AH K L UW D IH D
SKINOF	S K IH N AH F
PHAETON	F IY T AH N
AMBERED	AE M B ER D
ELONGATES	IH L AO NG G EY T S
DIUERS	D AY UW AH R Z
VANQUISHES	V AE NG K W AH SH AH Z
HONEYDEWS	HH AH N IY D UW Z
SHOEBILLS	SH UW B IH L Z
PEDIGREEDMEAT	P AH D IH G R IY D M IY T
TOREACH	T AH R IY CH
BOSPORUS	B AA S AH R AH S
SHOEHORNS	SH UW HH AO R N Z
FROMTHE	F R AA M DH
LOVEBIRDS	L AH V B ER D Z
TUKKED	T AH K T
MALIGNER	M AH L AY N ER
UNACCOMPLISH	AH N AH K AA M P L IH SH
MG/NIGHT	M G N AY T
CRASHAW	K R AE SH AH
SAXO	S AE K S OW
UNS	AH N Z
WHISTLIN	W IH S T L AH N
MIRRORMY	M AH R AO R M IY
DINTS	D IH N T S
SAMEBONES	S EY M B OW N Z
MADELEINES	M AE D AH L IY N Z
ADORAR	AH D OW R ER
JINOTEGA	JH AH N AA T AH G AH
MANTOVANA	M AE N T AA V AH N AH
RYBEDEROLLES	R AH B EH D AH R AH L Z
COFFINED	K AO F AH N D
GESSE	JH EH S
HALIDOM	HH EY L IY D AH M
FANTASM	F AE N T AH Z AH M
IMBROILES	IH M B R OW AH L Z
WAGONLOADOF	W AE G AH N L OW D AH F
CAPOLLOSTAND	K AE P AH L AA S T AH N D
WELTERS	W EH L T ER Z
THISSUDDEN	DH AY Z S AH D AH N
BENWOOD	B IY AH N W UH D
DOGARE	D AA G AH R
SALTINE	S AE L T AY N
BELOWRIP	B IH L OW R IH P
RAMBUTAN	R AE M B Y UW T AH N
SOWNDE	S OW N D
TRAMARITAL	T R AE M AH R AY T AH L
EDIFIED	EH D AH F AY D
SAGITTA	S AH JH IH T AH
ILLER	IH L ER
ALL/	AO L
NAILÈD	N EY L D
MENELAOS	M AH N EH L EY AH Z
RUNNELLED	R AH N AH L D
OBSERVD	AA B S AH R V D
THERES	DH EH R Z
BISMOL	B AY S M AA L
MEIT	M IY T
OOL	UW L
DORIES	D UW R IY Z
WINDFIELDS	W IH N D F IY L D Z
HOOING	HH UW AH NG
AGGERVATIN	AE JH AH R V AH T AH N
TAKETHIS	T EY K IH TH IY Z
PALLOUR	P AE L AH R
KLONDYKE	K L AA N D AY K
WATERFALLIN	W AO T ER F AO L IH N
TRANSUBSTANTIATED	T R AE N S AH B S T AE N T AY EY T AH D
PENING	P EH N IH NG
TEANGANÍOS	T IY N G AH N AH Z
MINGY	M IY IH NG IY
NÁÁHASDGAPLESS	N HH AE Z AE P L AH S
PHILOSOPHIE	F AH L AA S AH F IY
1893	W AH N EY T N AY N TH R IY
DUSTPAN	D AH S T P AE N
DREAMFUL	D R IY M F AH L
LARN	L AA R N
METROPOLE	M EH T R OW P OW L
UNBETRAYABLE	AH N B IH T R EY AH B AH L
THOMISTS	TH AA M AH S T S
CHAINSMOKES	CH EY N S M OW K S
SKETCHPAD	S K EH CH P AE D
HOLETHEY	HH AA L AH TH IY
BUNDL	B AH N D L
FURROWING	F ER OW IH NG
DAYMY	D EY M IY
SQUIRRELIT	S K W AH R AH L AH T
OAKARE	OW K AH R
¿A	AH
IRETHA	IH R AH TH AH
NIGHTSHE	N AY T
MOZAMBIC	M AA Z AH M B AH K
ONEOFF	OW N IY AH F
C18H32O2	S IY W AH N EY T EY CH TH R IY T UW OW T UW
SCREAM–THE	S K R IY M DH
TH'UNWORTHY	TH AH N W AH R DH IY
ANYAN	AE N AY AH N
MOJAVÉ	M AA JH AH V
MEYOU	M EY UW
HONOURS	AA N ER Z
HAUTEUR	HH AO T AH R
EMPOLI	IH M P OW L IY
PR	P IY R
VOOMED	V UW M D
COMEN	K AH M AH N
MOONY	M UW N IY
CHUIMHNÍOS	CH UW M HH N AH Z
STAIRCASEI	S T AE AH R K EY S IY
CELLARER	S EH L ER ER
FOUNDA	F AW N D AH
GUFFAWED	G AH F AO D
FACEWITH	F EY S W IH TH
TOWERETH	T AW ER IH TH
PERSEIDS	P AH R S AY D Z
FISTFIGHT	F IH S T F AY T
PREFERRETH	P R IH F ER IH TH
HUTMENT	HH AH T M AH N T
CUSTODYBROKENHOLYSTONEAT	K AH S T AH D IY B R OW K AH N HH OW L IY Z T AH N IY
SELVIDIDN	S EH L V AH D AH D N
WREKIN	R EH K AH N
ENGADINE	IH N G AH D AY N
PLACEFOR	P L EY S F AO R
CUDS	K AH D Z
INKSTANDS	IH NG K S T AE N D Z
RODDED	R AA D IH D
SUPERMOON	S UW P ER M UW N
SOV'REIGNTY	S AA V R EY N T IY
1,500	W AH N F AY V Z IY R OW Z IY R OW
MOPERS	M AA P ER Z
MOCKT	M AA K T
PROBINGLY	P R OW B IH NG L IY
STOPP	S T AA P
UNFASTENEDMY	AH N F AE S T AH N EH D M IY
JARMO	JH AA R M OW
ERDE	AH R D
THEMBUT	TH EH M B AH T
ALLACE	AO L EY S
TRACKTO	T R AE K T OW
DOUBLOON	D AH B L UW N
PAIMENT	P EY M AH N T
BECALMS	B IH K AA M Z
TOLDA	T OW L D AH
MWOLD	M W OW L D
HOUSWIFE	HH AW S W AY F
ROUNCIVALE	R AW N S AH V EY L
UNSITTABLE	AH N S IH T AH B AH L
SHOUTIN	SH AW T IH N
BOOTMAKER	B UW T M EY K ER
FEELA	F IY L AH
WATERYAT	W AH T EH R AY AH T
ENCHASED	EH N CH EY S T
BEATITUDES	B IY AE T AH T UW D Z
DESIRERS	D IH Z AY ER ER Z
VERMOUTHWHILE	V AH R M AW TH W AH L
THERTO	TH AH R T OW
ACEDIA	AH S IY D IY AH
SERUE	S EH R UW
BATSPOK	B AE T S AH K
68	S IH K S EY T
PRYNCE	P R IH N S
ANGLOED	AE N G L OW D
HOMEKIND	HH OW M K AY N D
DODDER	D AA D AH R
FEMINIZED	F EH M AH N AY Z D
BRAX	B R AE K S
TEMPLESACRAMENT	T EH M P AH L S AE K R AH M AH N T
DRAYHORSE	D R EY HH AH R S
BETROTHÈD	B IH T R AA TH D
DEADENED	D EH D AH N D
HILGEFORD	HH IH L JH AH F AH R D
HERDE	HH AH R D
UNFAINED	AH N F EY N D
SUNSTRUCK	S AH N S T R AH K
VOCALIZING	V OW K AH L AY Z IH NG
HÓZHFOULMOUTHED	HH Z HH F OW L M AW DH D
LACEWINGS	L EY S W IH NG Z
THESITATETO	TH EH S AH T AE T AH T OW
BEEEE	B IY IY
LEALAND	L IY L AH N D
NIGHTGOWNS	N AY T G AW N Z
EXPRESLY	EH K S P R IY S L IH
YARDBY	Y AA R D B AY
CHINS	CH IH N Z
IMPRIS	IH M P R AY Z
RUMGUNSHOCH	R AH M G AH N SH AH CH
TASHI	T AE SH IY
LAWBOOK	L AO B UH K
ROUNDABOUTAND	R AW N D AH B AW T AH N D
DIDNO	D IH D N OW
LIGHTYOU	L AY T AY UW
CONFLATED	K AH N F L AE T IH D
DEDICATIONS	D EH D IH K EY SH AH N Z
SPARKL	S P AA R K L
IMMENSEIN	IH M EH N S IH N
HERYS	HH EH R AH Z
PARAMOURES	P AE R AH M OW Y AH R Z
BREFFNY	B R EH F N IY
ARSONED	AA R S AH N D
INU	AH N UW
BUTSPHERICALUNITS	B AH T S EH R AH K AH L UW N AH T S
TAILFRONT	T EY L F R AH N T
ELIOTS	IY L IY AH T S
HONOR2	EY CH OW EH N OW AA R T UW
ERTAKE	AH R T EY K
VIEUX	V Y UW K S
SINGSA	S IH N G S AH
TÁ	T IY
KEYSTONE–	K IY S T OW N
STREETE	S T R IY T
WINDSHOVES	W IH N D SH AH V Z
HELPETH	HH EH L P IH TH
WISERI	W IH S AH R IY
OBBLIGATO	AA B L IH G AH T OW
UNMATED	AH N M EY T IH D
DESIGNE	D AH S IH N
DESCRIPTIONINTO	D IH S R IH P T IY AH N IH N T OW
ANDUVE	AE N D Y UW V
DOPESKIN	D OW P S K IH N
VIRTUOSIC	V AH R T Y UW AH Z AH K
TWOULD	T W OW L D
TOOTHROAD	T UW TH R OW D
QUEECK	K W IY K
OVERPRIDE	OW V ER P R AY D
ARMOURY	AA R M ER IY
DODGINGSMEMORY	D AA JH IH NG Z M EH M AH R IY
TEXTSCAPES	T EH K S T S K EY P S
VOMITEST	V AA M AH T AH S T
BANDAGEDLIGHT	B AE N D IH JH D L AY T
PEARWOOD	P AE ER W UH D
2/2	T UW T UW
LIPSPROPHESIED	L IH P S P R AA F AH S AY D
ARMSDEVOURING	AA R M Z D IH V AW ER IH NG
GROUNDGURGLE	G R AW N D G ER G AH L
EVERYBUSHEL	IY V AH R IY B UH SH AH L
SEEPRESENT	S IY P R EH Z AH N T
EPAULETTE	EH P EY AH L EH T
GOATEEAND	G OW T IY AH N D
MEZZOTINTS	M EH T S OW T IH N T S
ALYPTIC	AE L AH P T AH K
EDDERS	EH D AH R Z
UNJOINED	AH N JH OY N D
PISMIRE	P IH Z M AY R
CHARLEMA'NE	CH AA R L AH M AH N
MEANINGENTIRELY	M IY N IH N JH EH N T AY ER L IY
BYNNE	B IH N
PORTMANTEAUS	P AO R T M AE N T IY AH S
URANIA	Y AH R EY N Y AH
AMNESIAS	AE M N IY S IY AH Z
GLISTERETH	G L IH S T AH R AH TH
PRESUMPTIONSOF	P R IY S AH M P T IY AA N S AH F
ASKLESS	AE S K L AH S
PELARGONIUM	P EH L AH R G OW N IY AH M
CONQU'RING	K AA N K W R IH NG
CLOGG	K L AA G
SELTZERS	S EH L T S AH R Z
ULTRAVIOLETS	AH L T R AH V AY AH L AH T S
KIDDISH	K IH D IH SH
BARBARISMS	B AA R B ER IH Z AH M Z
JOINTLESS	JH OY N T L AH S
CLUCKED	K L AH K T
GUAYACAN	G Y UW EY AH S AH N
PORTARAS	P AO R T AH R AH Z
UNLEAVINGMAKES	AH N L IY V IH NG M EY K S
PARADISING	P AE R AH D AY S IH NG
CODDLES	K AA D AH L Z
WITHHOLDE	W IH TH OW L D
FLEABAG	F L IY B AE G
ACCUSTOMING	AH K AH S T AH M IH NG
ENDORST	IH N D AO R S T
TITIANS	T IH SH AH N Z
WATCHTHE	W AA CH DH
ALLEGEAUNCE	AE L IY JH IY AH N S
FORBIDDER	F AO R B IH D ER
AQUASH	AH K W AA SH
SAWCARVED	S AO K AA R V D
BISTRE	B AY S T AH R
15	W AH N F AY V
MENIE	M EH N IY
FROWITH	F R OW AH TH
GASOLINEDISPEL	G AE S AH L IY N D IH S P EH L
MASTIC	M AE S T IH K
GLAZEDWITH	G L EY Z D W IH TH
MUSCLECLEAN	M AH S AH L K L IY N
FACEWHOSE	F AE S AH HH OW Z
IGNOREDSTILL	IH G N OW R D S T IH L
WHEELE	W IY L
ASSINIBOINE	AE S IH N AH B OY N
FIRMUS	F AH R M AH S
GUTSPILL	G AH T S P IH L
RANGDA	R AE N G D AH
DISCOVEREDAND	D IH S AH V EH R AH D AH N D
SAISONS	S EY Z AO N Z
REMERA	R AH M EH R AH
PAGANS	P EY G AH N Z
MAKESHADE	M EY K SH EY D
DOWNAND	D OW N AH N D
CHANC	CH AE NG K
VERTUOUS	V AH R T Y AH W AH S
YESBUT	Y EH Z AH T
GLORIE	G L AO R AY
ALEIKUM	EY L IY K AH M
THROUGHTO	TH R AO T OW
SOMTIMES	S AA M T AY M Z
GOINGTO	G OY N G T OW
INOTICE	AH N OW T AH S
SOPPY	S AA P IY
CAH	K AE
SOUTHERNE	S AW TH AH R N
MIGHTOF	M AY T AH F
JAGGY	JH AE G IY
HENNY	HH EH N IY
DISDAINERS	D IH S D EY N ER Z
CALCIFIES	K AE L S AH F AY Z
QUEENSCALLIGRAPHY	K W IY N Z K AH L IH G R AH F IY
EXERCISEMIGHT	EH K S ER S AY Z M AY T
DEEPNESS	D IY P N AH S
SACRÉ	S AE K R
SPACEBAR	S P EY S B AA R
UNTILBOTTOM	AH N T IH L B AA T AH M
MAKINGA	M AH K IH N G AH
OUTWEARS	AW T W AE ER Z
ANUNCIA	AH N AH N CH IY AH
FALR	F AE L R
HIMBASHA	HH IH M B AH SH AH
GRAVELLED	G R AE V AH L D
SKUFFING	S K AH F AH NG
DOWNWELLING	D AW N W EH L IH NG
CHEEKSTHE	CH IY K S DH
ANGELICANOTHER	AE N JH AH L AH K AE N AH DH AH R
LEAVEGRANT	L IY V G R AE N T
BARRIERISLAND	B AE R IY ER AY L AH N D
BEDEW	B IH D UW
SAUGHT	S AO T
LOVELEARNED	L AH V L ER N D
MISALLIANCE	M IH S AH L AY AH N S
TEMPESTS	T EH M P AH S T S
FORTHREE	F AO R TH R IY
UNDERGLAZES	AH N D ER G L EY Z IH Z
SPECTRES	S P EH K T ER Z
PLAYFELLOWS	P L EY F EH L OW Z
RIADA	R AY AH D AH
SPINDLES	S P IH N D AH L Z
NUNLY	N AH N L IY
OPPS	AA P S
CRACKLINGUNDERNEATH	K R AE K L AH N G AH N D AH R N IY TH
DAGGED	D AE G D
UNLESSES	AH N L EH S IH Z
STRAIT'ND	S T R EY T N D
BORDO	B IY ER D UW
SSUPERFLUOUSAS	S UW P AH R F L AH W AW S AH Z
SENSESIMPLY	S EH N S IH M P L IY
AFFAIRSWITH	AH F EH R Z W IH TH
IMPOSSIBLEBUD	IH M P AA S AH B AH L B AH D
HOLDENCAULFIELD	HH OW L D EH NG K AH L F IY L D
MICROSCOPICDIATOMS	M AY K R AH S K AA P IH K D AY AH T AA M Z
FISSIONING	F IH SH AH N IH NG
DEFENCELESS	D IY F EH N S L AH S
FAERIES	F AE ER IY Z
SOUNDAS	S AW N D AH Z
DERS	D EH R Z
HANDICAPABLE	HH AE N D IH K AE P AH B AH L
INSIDEBEHIND	IH N S AY D B IY HH AY N D
UNROLLEDAND	AH N R AA L AH D AH N D
FRIGHTED	F R AY T IH D
SERAIL	S AH R EY L
DRYBOROUGH	D R AY B ER OW
AYDE	EY D
MOTHERTHE	M AA TH AH R DH
ADVANTAGEOF	AE D AH N T EY JH IY AH F
EXCRESCENT	EH K S K R EH S AH N T
JOTTING	JH AA T IH NG
'DEAR	D IY AH R
DRYNKE	D R IH NG K
SLOATH	S L OW TH
WUH	W UW
CLASPINGWIRE	K L AE S P IH NG W AY ER
GRAINAND	G R EY N AH N D
CLOTHESLINES	K L OW DH Z L AY N Z
33	TH R IY TH R IY
NGCAMIÓN	N G K AE M AH N
MYSÉN	M IH Z N
ODDBECAUSE	AA D B IY K AO Z
IONIA	AY OW N Y AH
REMEMBERWE	R AH M EH M B AH R W
UNNEEDING	AH N IY D IH NG
CLACKING	K L AE K AH NG
FLAYER	F L EY AH R
1125	W AH N W AH N T UW F AY V
MAMACITAS	M AH M AE S AH T AH Z
BROKEINTO	B R OW K IY N T OW
HAIRFALL	HH EH R F AO L
HEARSEOUR	HH AH R S IY AH R
REINCARNATING	R IY IH N K AA R N EY T IH NG
WHICHLIES	W IH K L AY Z
KNOWEVEN	N OW IY V AH N
EIGHTROOMED	EY T R UW M D
GRAPEJUICE	G R EY P JH UW S
KOOLAU	K UW L AH
LILACOR	L AY L AE K ER
CEREBELLA	S EH R AH B EH L AH
CLUDING	K L UW D AH NG
PAWL	P AO L
DEVILLIS	D IY V IH L IY Z
ANNULMENTS	AE N AH L M AH N T S
GREENHORNS	G R IY N HH AO R N Z
BANISHER	B AE N IH SH ER
ELIMINAT	AH L IH M AH N AH T
INTERPOSITION	IH N T ER P AH Z IH SH AH N
REMEMBERINGWHEN	R AH M EH M B AH R IH N G W AH N
PUNCTUATES	P AH NG K CH AH W AH T S
SUPREAME	S AH P R IY M
STILLIN	S T IH L IH N
SINGULARSPOKEOF	S IH N G Y UW L AH R S OW K IY AH F
LULLABYPULLED	L AH L AH B AY P UH L D
MITCHING	M IH CH AH NG
COTCHING	K AA CH AH NG
NAK	N AE K
MÁRGARÉT	M R G AA R T
CONSTANCIE	K AA N S T AH N S IY
FORTLESS	F OW R T L AH S
DISAPPEARSON	D IH S AH P IH ER S AH N
SEENAND	S IY N AH N D
DANCERLY	D AE N S ER L IY
LIGHTCONSIDER	L AY T K AH N S IH D ER
SATCHELS	S AE CH AH L Z
WIGHTS	W AY T S
DEADACROSS	D EH D AH K R AO S
ULTRAHIGH	AH L T R AH HH AY
KUUT	K Y UW AH T
MAYBECUT	M EY B IY K AH T
HOCKS	HH AA K S
ASTONISHMENTS	AH S T AA N IH SH M AH N T S
CORNLAND	K AO R N L AE N D
THENSHE	TH EH N SH
SOAPBUBBLE	S OW P B AH B AH L
1862	W AH N EY T S IH K S T UW
COCKSUREWITH	K AA K SH UH R W IH TH
NOBBED	N AA B D
FLESHLIEST	F L EH SH L IY AH S T
HASA	HH AE S AH
TWITCHINGTHE	T W IH CH AH N G
AFLOTE	AE F L OW T
GUTTA	G AH T AH
DIEDHER	D IY D AH R
TWILIGHTING	T W AY L AY T IH NG
ARVEIRON	AA R V EY R AH N
QS	K Y UW S
HEARTSTRINGS	HH AA R T S T R IH NG Z
SWELT	S W EH L T
BEWINGED	B IH W IH NG D
BATHWATER	B AE TH W AO T ER
PLUMPER	P L AH M P ER
IGNITEDBY	IH G N AY T IH D B AY
TAUGHTTO	T AO T OW
PALLS	P AO L Z
ODORI	AA D AH R IY
WEATHERBOARD	W EH DH ER B OW R D
ESCLATER	EH S L EY T AH R
WASNO	W AA Z N OW
PLACESDREAMING	P L EY S IH Z D R IY M IH NG
GARDENIAS/	G AA R D IY N Y AH Z
SHES	SH IY Z
BHRÉAGACH	B HH R AE G AH CH
DENCH	D EH N CH
OINKED	OY NG K T
DEARTHAN	D IY AA R TH AH N
DISPORT	D IH S P OW R T
NARWHALS	N AA R W HH AH L Z
UNCIRCUMSCRIPT	AH N S ER K AH M S K R IH P T
KNOWSEXACTLY	N OW S EH K S AE K T L IY
WOODCRAFT	W UH D K R AE F T
INTUITIST	IH N T UW AH T IH S T
DAEMONS	D IY M AH N Z
MARGINALIA	M AA R JH AH N EY L Y AH
CRERAR	K R IY R AH R
DECAYTIC	D AH K EY T AH K
IVRY	IH V R IY
BENTOS	B IY AH N T AA S
HWŒBIGGE	W B IH JH
WHOLELOVE	HH OW L AH V
GETUPS	G EH T AH P S
1992	W AH N AY N AY N T UW
BOURGOIS	B AH R G OW AH S
MASCARAED	M AE S K AE R AH D
VOICEHUM	V OY S HH AH M
SHIMSKIS	SH IH M S K AY Z
SEEM'ST	S IY M S T
PISTACHE	P IH S T AH CH
PRIVILY	P R IH V IY L IY
SOMEONEELSE	S OW M IY AH N IY L S
INVOKER	IH N V OW K ER
BEASTSPARADING	B IY S T S P EH R EY D IH NG
PECKISH	P EH K IH SH
TREATE	T R IY EY T
NANCYS	N AE N S AH Z
FERDOWSI	F AH R D AH S IY
FLAGGON	F L AE G AH N
UNDEFENDED	AH N D IY F EH N D IH D
CEALS	S IY L Z
ALWAYSHER	AE L W EY SH AH R
THEOPHILUS	TH IY AH F AY L AH S
VACATES	V EY K AH T S
BALIKBAYAN	B AH L IH K B EY AH N
EXORCIZE	IH G Z AO R S AY Z
WORDSTARS	W ER D S T AA R Z
AFF	AE F
NEUMS	N Y UW M Z
GRANT7	JH IY AA R EY EH N T IY S EH V AH N
BRICHTOVA	B R IH CH T AH V AH
ROOTORRIS	R UW T ER R IY Z
HORTICULTURISTS	HH AO R T AH K AH L T Y AH R AH S T S
OTHERES	AH TH IY R Z
SEXTANTS	S EH K S T AH N T S
ATTONCE	AE T AH N S
SLEEPWALKED	S L IY P W AO K T
FITMY	F IH T M IY
AMITIE	AH M AY T IY
STREETLAMPS	S T R IY T L AE M P S
WINGTIPS	W IH NG T IH P S
PLACKETINGS	P L AE K AH T AH NG Z
C57H98O6	S IY F AY V S EH V AH N EY CH N AY N EY T OW S IH K S
HIEROPHANT	HH IY R AH F AH N T
DIAMONDSBY	D AY M AH N D Z B AY
ABOUTNESS	AH B AW T N AH S
MALICEIT	M AE L AH S IY T
SWOONEDFOR	S W UW N EH D F AH R
MILKTRUCKS	M IH L K T R AH K S
NEWTLIKE	N UW T L AY K
CONCEIVES	K AH N S IY V Z
ERYCINE	EH R AH S AY N
UNSCREW	AH N S K R UW
ABSURDUM	AE B S AH R D AH M
THUMBSTUMP	TH AH M S T AH M P
DORK	D AO R K
MANHE	M AE N HH
ITAN	AY T AH N
ASTONISHEDBY	AH S T AA N IH SH T B AY
ITTER	IH T AH R
UNITWHILE	AH N IH T W AH L
PREDA­TORY	P R IY D EY T ER IY
ONEJUST	AA N AH JH AH S T
JOYNTS	JH OY N T S
THEREBETWEEN	TH EH R AH B EH T W IY AH N
BIRCHIN	B ER CH IH N
SNIGGERED	S N IH G ER D
CHORUSAND	CH AH R UW S AH N D
AETERNO	AH T AH R N OW
LIMBSBUILDING	L IH M Z B IH L D IH NG
FORMD	F AO R M D
MINJOON	M IH N JH UW N
BRAGGARTS	B R AE G AH R T S
CRAPHEAD	K R AE P HH EH D
ENVIER	EH N V IY ER
DAYFOR	D EY F AO R
ADMINISTRATIONTHE	AE D M AH N AH S T R EY T IY AH N DH
DELIGHTAS	D AH L AY T AH Z
THEMSELVESINTO	TH EH M Z EH L V AH S IH N T OW
FLOWNWHEN	F L OW N W AH N
CORNERSOF	K AA R N AH R S AH F
FANSIED	F AE N Z IY D
PILLOWY	P IH L OW IY
MORTALBODY	M AO R T AH L B AA D IY
OROONOKO	AH R UW N AH K OW
GESTALT	JH EH S T AH L T
IMAGEBEHIND	IH M IH JH B IY HH AY N D
SCYTHING	S IH DH AH NG
SOIS	S OY Z
ROLDE	R OW L D
XACTLY	Z AE K T L IY
CONNIVANCES	K AH N AY V AH N S IH Z
DRAYCOTT	D R EY K AH T
CLUMBED	K L AH M D
BRIERS	B R IY R Z
ZUAR	Z UW W AH R
STRONGPROTECTS	S T R AO NG P R AH T EH K T S
FINGERSIN	F IH NG G ER S IH N
BUILDED	B IH L D IH D
HOOK–	HH UH K
WALKT	W AA L K T
KINGSNAKE	K IH NG S N EY K
PUCKEREDRUBBER	P AH K ER D R AH B ER
SLIVERING	S L IH V ER IH NG
BAGGES	B AE G Z
FOLLOWETH	F AA L OW IH TH
MOSTTHAT	M AA S T TH AH T
SQUAREFIT	S K W EH R F IH T
SEVENTYTWO	S EH V AH N T IH T W OW
CARROCK	K AA R AA K
PEACENIKS	P IY S AH N AH K S
PREZ	P R EH Z
SHIRTWAIST	SH ER T W EY S T
FIDDLINGS	F IH D AH L IH NG Z
ICOULD	AH K OW L D
FLAGS/	F L AE G Z
SLEEPLIKE	S L IY P L AY K
GLYCOPROTEINS	G L AH K AA P R AH T IY N Z
RECLUSION	R IH K L UW ZH AH N
WAYFINDER	W EY F AY N D ER
ICOSAHEDRON	IH K AH S AH HH EH D R AH N
90	N AY N Z IY R OW
HARMONISING	HH AA R M AH N IY Z IH NG
RAKOSI	R AE K AH S IY
BAGGEDALONG	B AE G D AH L AO NG
HUREBERS	HH Y UH R AH B AH R Z
INESSENTIAL	IH N IH S EH N CH AH L
BEHELDST	B AH HH EH L D S T
ALLEGRETTO	AE L AH G R EH T OW
LIFEWHEN	L IH F Y UW AH N
STAAAY	S T AA EY IY
INFLICTEDPROFOUND	IH N F L IH K T IH D P R OW F AW N D
FLATBEAD	F L AE T B IY D
COMICIGNORANCE	K AA M IH K IH G N AH R AH N S
DENIEST	D IH N AY AH S T
OM	AA M
CROATOAN	K R OW T OW AH N
UNWATCHED	AH N W AA CH T
ATTAINE	AE T EY N
IOYE	AY OY
CHANTERELLE	CH AE N T AH R AH L
UNPREPAR	AH N P R IY P AA R
REIFY	R IY AH F AY
1722	W AH N S EH V AH N T UW T UW
CONCERND	K AA N S AH R N D
WATS	W AA T S
SAYINGLY	S EY IH NG L IY
FREEEQUENTLY	F R IY EH K W EH N T L IY
SCARPERIA	S K AA R P IY R IY AH
BUGBEAR	B AH G B AE ER
MOUNTINGS	M AW N T IH NG Z
PIECEMEALE	P IY S AH M IY L
SKYBUT	S K IH B AH T
ACTÆON	AE K T AO N
CHONK	CH AO NG K
SENCELESSE	S EH N S AH L AH S
WOVEST	W OW V AH S T
SENSETO	S EH N S AH T OW
MADD'NING	M AE D N AH NG
WEATHERY	W EH DH ER IY
DRIZZLES	D R IH Z AH L Z
SKINTHE	S K IH N DH
NEN	N EH N
TIKIS	T AY K AH S
MUSEO	M Y UW S IY OW
ONLYWHAT	AA N L IH W HH AH T
TIMEPIECES	T AY M P IY S IH Z
MBARKT	M B AA R K T
THUMBWHILE	TH AH M B W AH L
THISLIFE	DH AY Z L AY F
REMIXED	R IY M IH K S T
SNOWFIELDBELOW	S N OW F IY L D B IH L OW
ÀGÀN	JH IY N
ATT	AE T
5000	F AY V Z IY R OW Z IY R OW Z IY R OW
WARMEEARTHS	W AO R M IY ER TH S
CITIED	S IH T IY D
GOONCH	G UW N CH
KEENINGWILL	K IY N IH NG W IH L
CUMBERS	K AH M B ER Z
DECEIVERS	D IH S IY V ER Z
BYTWENE	B IH T W IY N
MANAGETH	M AE N IH JH IH TH
UNNURSED	AH N ER S T
HAVETO	HH AE V AH T OW
RIGWOODIE	R IH G W UH D IY
SATISFYED	S AE T AH S F AY D
IMPOSTERS	IH M P OW S T ER Z
WHATSAID	W AA T S EY D
SEISURE	S AY ZH Y AH R
TOTTERED	T AA T ER D
95	N AY N F AY V
SEISMICALLY	S AY Z M IH K AH L IY
LOQUANTUR	L AA K W AA N T AH R
SHUFFLERTHE	SH AH F L AH R DH
DEAVE	D IY EY V
SELFLIKE	S EH L F L AY K
MESSIAS	M EH S IY AH Z
KNEADED	N IY D IH D
NOOKOF	N UH K AH F
COSINE	K OW S AY N
**	
OFFGUARD	AO F G AA R D
MISCONNECTION	M IH S K AH N EH K SH AH N
PF	P IY F
HOUSEFLY	HH AW S F L AY
COINEDTO	K OW AH N EH D T OW
COMMUNITIESHAVE	K AA M Y AH N IH T AH SH EY V
THRIVETH	TH R AY V IH TH
PADAM	P AE D AH M
STORYTHE	S T AO R AH DH
FORMFORECASTLESLIPCLICHÉ	F AO R M F AH R AH K AE S T L AH Z L IH P L AH CH
******	
GLORIFI	G L AO R AH F IY
VORACIOUSLY	V AH R EY SH AH S L IY
REDUCTIVE	R IY D AH K T IH V
CHIMELESS	CH AY M L AH S
QUARRELLING	K W AO R AH L IH NG
STARLESS	S T AA R L AH S
BIRDWING	B ER D W IH NG
SATLEY	S AE T L IY
THEPARADOXICAL	TH AH P AE R AH D AA K S IH S AH L
PERIWINKLE	P EH R IH W IH NG K AH L
UNLOVABLE	AH N L AH V AH B AH L
PONTIFFS	P AA N T AH F S
WAPPINGER	W AA P AH NG AH R
YESTER	Y EH S T AH R
UHURA	AH HH Y AH R AH
SUITERS	S W IY T ER Z
STRUCKWHILE	S T R AH K W AH L
SPILLEDTHE	S P IH L AH D
FLEERING	F L IY R IH NG
NIHIL	N IH HH AH L
ICEBUCKET	AY S B AH K AH T
BREASTPLATES	B R EH S T P L EY T S
OLDMIXONS	OW L D M IH K S AO N Z
LOWRIDER	L OW R AY D ER
UNSHADED	AH N SH EY D IH D
CLEAVED	K L IY V D
DAYERYE	D EY AH R AY
GHOSTLYFIGURES	G OW S T L IY F IH G Y ER Z
BOOKSTHE	B UH K S DH
SOULFROM	S OW L F R AH M
LUPINES	L UW P AY N Z
SENSUALAND	S EH N S W EY L AH N D
REULED	R IY AH L D
RECLUSES	R IH K L UW S IH Z
TURVES	T AH R V Z
KEGON	K EH G AO N
DUSKY	D AH S K IY
MCCOMSKY	M K AA M S IY
ITSELFTEN	IH T S EH L F T AH N
HEIGH	HH EY
RIGMAROLES	R IH G M AH R OW L Z
LASTLYE	L AE S T L AY
BROCHE	B R AA CH
EAVED	IY V D
MANLITERALLY	M AE N L IH T AH R AH L IY
SHTHOUGHTSENSIBLE	SH TH AO T S EH N Z AH B AH L
GIRLWAS	JH AH R L W AH Z
SCARVED	S K AA R V D
COUCH'T	K OW AH CH T
KNIGI	N IH JH IY
KEEPHER	K IY F AH R
PHANTOMWISE	F AE N T AH M W AY Z
AIRWE	AE AH R W
TIMEON	T AY M AO N
CHOLER	CH OW L AH R
ONEHAS	AA N AH HH AH Z
AMMA	AE M AH
POTTERED	P OW T ER D
CALLADOS	K AO L AH D UW Z
CHILDBED	CH AY L D B EH D
SUPPORTIN	S AH P OW R T IH N
ASTRINGENCY	AH S T R IH N JH AH N S IY
EXPANDO	EH K S P AE N D UW
INTERIORITY	IH N T IH R IY ER AH T IY
KWOCK	K W AA K
DWELL'ST	D W EH L S T
GIM	JH IH M
LIFETO	L IH F AH T OW
FLAPAWAY	F L AE P AH W EY
REDTHAT	R IH D TH AE T
WAYSIDEAS	W EY Z AY D IY AH Z
CYANOSIS	S AY AH N OW S AH S
VOLITIONAL	V OW L IH SH AH N AH L
FETLOCKS	F EH T L AH K S
MUDDINESS	M AH D IY N AH S
TOP–	T AA P
UNORGANIC	AH N AO R G AE N IH K
CANCELD	K AE N S AH L D
TANBARK	T AE N B AA R K
MILLENNIALS	M IH L AH N IY AH L Z
COLÚIR	K OW L IH R
ONCEFUNDS	AA N S AH F AH N D Z
PROPRIETIES	P R AH P R AY AH T IY Z
ZORIVAX	Z AO R AH V AH K S
SEAWAS	S IY W AH Z
NWARD	N W AO R D
JUICEFROM	JH UW S EH F R AH M
WHIPLASHED	W IH P L AE SH T
UNCHAPERONED	AH N SH AE P AH R OW N D
STOLES	S T OW L Z
ALONEIN	AH L OW N IH N
TETRADRACHMS	T EH T R AE D R AH CH M Z
INKLIKE	IH NG K L AY K
BALLSSHEATHED	B AO L Z SH IY DH D
TURMES	T AH R M Z
MÜSSEN	M IH Z AH N
PRESERV	P R IY S AH R V
COMPLACENCE	K AH M P L EY S AH N S
FOOTSTOOLS	F UH T S T UW L Z
KARINHALL	K AH R IH N HH AH L
RUNAWAYSONE	R UW N AH AH S OW N
OPTIMISMWAS	AA P T AH M IH Z M W AH Z
CLOWNISHLY	K L AW N IH SH L IY
1895	W AH N EY T N AY N F AY V
PAGOD	P AE G AH D
PASCHKOWSKI	P AE S OW S IY
HEELSTABBING	HH IY L S T AE B IH NG
HOSANNAH	HH AH S AE N AH
BUCKTEETH	B AH K T IY TH
BOLSHEVIKI	B OW L SH EH V AH K IY
STREAMSTURNS	S T R IY M Z T ER N Z
EBBER	EH B ER
PLAYBOYS	P L EY B OY Z
CLEPSYDRA	K L EH P S IH D R AH
BIRDSAND	B ER D S AE N D
SPAM*	S P AE M
ASIANNESS	EY S IY AE N AH S
365	TH R IY S IH K S F AY V
INVEIGLING	IH N V EY G L AH NG
BRENNENBRENNENBRENNENBRENNENBRENNENBRENNENBRENNENBRENNEN	
KNIFEBLADES	N AY F B L EY D Z
WIDEWES	W IH D Y UW Z
STÜRBE	S T R B
RUBBINGS	R AH B IH NG Z
HUMPBACKED	HH AH M P B AE K T
EUPHORBIAS	Y UW F AO R B IY AH Z
WIKKE	W IH K
SEENMY	S IY N M IY
FORGRUESOME	F AO R G R UW S AH M
KIEFEKIL	K IY F AH K AH L
MULTEITY	M UH L T IY AH T IY
CLINKING	K L IH NG K IH NG
10:18	W AH N Z IY R OW W AH N EY T
THOUGHTMOST	TH AO T M OW S T
OPON	AA P AH N
CORS	K AO R Z
LYRES	L AY R Z
HANDCLAP	HH AE N D K L AE P
HALTTO	HH AE L T OW
SHIRRED	SH AH R D
PLANTSEEDS	P L AE N T S IY D Z
WANTEDAS	W AA N T AH D AH Z
AILEYESQUE	AH IH L AY EH S K
BEWITCHES	B IH W IH CH IH Z
CLIMBE	K L IH M
OPENTHE	AA P AH N DH
UNIMPORTANTAFTER	AH N IH M P OW R T AE N T AE F T ER
BACKWITH	B AE K W IH TH
MICRONIZED	M AY K R AA N AY Z D
ALBEYTTE	AE L B EY T
MULCHY	M AH L CH IY
LAMED	L EY M D
MINEAWASH	M AY N AH W AA SH
TERMITICIDE	T AH R M IH T AH S AY D
PLUMPERS	P L AH M P ER Z
MESHTHOSE	M EH SH TH OW Z
SPECT	S P EH K T
FULLSCREEN	F UH L S K R IY N
OILSKIN	OY L S K IH N
GAVEST	G EY V AH S T
REQUICKEN	R IY K W IH K AH N
ARMS/	AA R M Z
JOFFRE	JH AA F AH R
DESARROLIMIENTO	D AH S AE R AH L AH M IY N T OW
FIBRILLATING	F IH B R AH L EY T AH NG
UNIVERSESTRETCHING	Y UW N AH V ER S T R EH CH IH NG
OFTENFOLLOWED	AO F AH N F AA L OW D
CONFERRD	K AA N F EH R D
ATTITUDETHAT	AE T AH T Y UW D AH TH AH T
PHYTOLITHIC	F IH T AH L AH TH AH K
QUSLEDGES	K W Z L EH JH AH Z
COMUS	K OW M AH S
NUTSAND	N AH T S AE N D
ADDENDA	AE D EH N D AH
SORWES	S AO R W Z
WEATHERWORN	W EH DH ER W OW R N
ARELIKE	AH R IY L AY K
GOSPODA	G AA S AH D AH
BEACHCOMBING	B IY CH K OW M IH NG
DAYTHRO	D EY TH R OW
WORLDES	W AH R L D Z
HANDMAYDS	HH AE N D M EY D Z
NAPEOF	N EY P IY AH F
SOMEONEAT	S OW M IY AH N IY T
RAHKEEITCHINGS	R AH K IY AH CH AH NG Z
RETREATE	R IH T R IY EY T
SHAFI	SH AE F IY
OWT	OW T
THUMBELINA	TH AH M B EH L AH N AH
GREETHESE	G R IY TH IY Z
ALGOPHOBIA	AE L G AH F OW B IY AH
PLATANUS	P L AE T AH N AH S
WATERBIRDS	W AO T ER B ER D Z
RUTTING	R AH T IH NG
CREASELESS	K R IY S L AH S
RADHOŠFULLFLIGHT	R AE D HH AA F AH L F L AY T
FLUBBER	F L AH B ER
TRUMANS	T R UW M AH N Z
TUSKER	T AH S K ER
ODALISQUE	AA D AH L AH S
AUTOMATICAIMED	AO T AH M AE T IH K EY M D
1787	W AH N S EH V AH N EY T S EH V AH N
KENNSA	K EH N S AH
PLARR	P L AE R
MABINI	M AE B AH N IY
PACKEDWITH	P AE K T W IH TH
SUMMERISMUS	S AH M AH R IH Z M AH S
NYSEIAN	N AY Z IY IY AH N
UNSYMPATHETICALLY	AH N S IH M P AH TH EH T IH K AH L IY
NOTNOT	N AA T N AH T
MILKTO	M IH L K T OW
TINSAND	T IH N S AE N D
AIMEDFOR	EY M D F AO R
SOOTHLY	S UW TH L IY
FOURSPENNIES	F OW R Z P EH N IY Z
LEAPER	L IY P ER
POIS'NOUS	P OY S N AH S
WINDOWSCAPES	W IH N D OW S K EY P S
LOREOF	L AO R IY AH F
REGARDAIENT	R IY JH ER D EY AH N T
CULLUDS	K AH L AH D Z
CAROLLED	K AE R AH L D
'SWEET	S W IY T
GODI	G OW D IY
MASKMAKER	M AE S K M EY K ER
OND	AA N D
STROWN	S T R OW N
HOLLOWER	HH AA L OW ER
SAYONARA	S EY AA N AH R AH
ROSENCAVALIER	R OW Z AH N K EY V AH L IY ER
SCHOOLISH	S K UW L IH SH
FUGAL	F Y UW G AH L
SHEETROCK	SH IY T R AA K
THEMWOOPIES	TH EH M W AH P AY Z
CRAWLER	K R AO L ER
IHRE	IH R
COMETHTHEY	K AH M EH TH IY
THANNE	TH AE N
SELFNOI	S EH L F N OY
HATHTHEE	HH AE TH IY IY
GETAND	JH EH T AH N D
GRANDEE	G R AE N D IY
RAGGEDLY	R AE G AH D L IY
HOUSEPIPES	HH AW S P AY P S
THUNDERCLAPS	TH AH N D ER K L AE P S
PIGFOOT	P IH G F UH T
1972	W AH N AY N S EH V AH N T UW
SPRAWLINGLOOPS	S P R AO L IH NG L UW P S
INNCIDE	IH N S AY D
BEENMY	B AH EH N M IY
WAUKIN	W AO K AH N
PRYEST	P R AY AH S T
DEID	D IY IH D
BLANKETTS	B L AE NG K EH T S
WHAR	W AA R
PHILISTINEI	F AH L IH S T AH N IY
GRANDCHILDE	G R AE N D CH AH L D
DAMYATA	D AH M AY AH T AH
FOREBEARERS	F OW R B AE ER ER Z
19TH	W AH N AY N T IY EY CH
SPREADINGOVER	S P R EH D IH NG OW V ER
VREGARDLESSLY	V R AH G AA R D L EH S L IY
MADRONE	M AE D R OW N
PLASTICIZERS	P L AE S T IH K AY Z ER Z
TRYSTS	T R IH S T S
MISLABELEDHIS	M IH S L AH B EH L AH D AH S
RUDENESSIN	R UW D N AH S IH N
PACKINGTOWN	P AE K IH NG T AW N
FROTHEDAN	F R AA TH AH D AH N
PROSERPINAS	P R OW S AH R P AH N AH Z
WHUMMLE	W AH M AH L
SISTAS	S IH S T AH Z
PEARLS…	P ER L Z
SÔ	EH S
SDEFUNCT	S D EH F AH NG K T
8/3	EY T TH R IY
ORICHALCI	AO R AH CH AE L S IY
RAINKING	R EY N K IH NG
1973	W AH N AY N S EH V AH N TH R IY
ITHAPPEN	AH TH AE P AH N
ROOFSFOR	R UW F S F AO R
MISFORMED	M IH S F AO R M D
ANAGRAMMATIZE	AE N AH G R AE M AH T AY Z
SCIENTIA	S IY N CH IY AH
ERMUNG	AH R M AH NG
PIECESOF	P IY S AH S AH F
JONAGOLD	JH AA N AH G OW L D
GROTESQUERIE	G R OW T EH S K ER IY
ACHIOTE	AE CH IY OW T
GLUTTONIES	G L AH T AH N IY Z
SPENARD	S P EH N AH R D
PANGENESIS	P AE N JH EH N AH S AH S
2WE	T UW D AH B AH L Y UW IY
LEMOYNE	L AH M OY N
SKETCHOF	S K EH CH AH F
NEOCONS	N IY OW K AA N Z
DREAMINGABOUT	D R IY M IH N G AE B AW T
FELLOWFILTH	F EH L OW F IH L TH
THREATN	TH R IY T N
FINIT	F IH N AH T
FARSET	F AA R S EH T
WALKETH	W AO K IH TH
FINGERSONE	F IH N JH AH R S OW N
HEARTPERFORMED	HH AA R T P ER F AO R M D
COMADAM	K OW M AE D AH M
SHAMASH	SH AE M AE SH
EXECRATIONS	IH G Z EH K R EY T IY AH N Z
WHEELINGMADLY	W IY L IH NG M AE D L IY
IMPERMANENCE	IH M P ER M AH N AH N S
MAJORPUTS	M EY JH ER P UH T S
CARFROM	K AA R F R AH M
FEARST	F AH R S T
ZINGED	Z IH NG D
LILIFIED	L IH L AH F AY D
4HOLDING	F OW R EY CH OW EH L D IY AY EH N JH IY
ROOMWAS	R UW M W AH Z
PINKPOCKET	P IH NG K P AA K AH T
DISAPPEARSTHE	D AH S AE P AH R S DH
WOLFS	W UH L F S
UTT'RED	AH T R D
LOVE/LOVE	L AH V L AH V
MOOLMAN	M UW L M AH N
TURBIO	T AH R B IY OW
CONTRARIOUS	K AA N T R EH R IY AH S
SNOWETH	S N OW IH TH
HEAUEN	HH IY UW W AH N
INTRODUC	IH N T R AA D AH K
STOFFS	S T AA F S
SENSEOF	S EH N S IY AH F
LANGUAGESAND	L AE NG G W IH JH S AE N D
STROWD	S T R OW D
SOUTHNESS	S AW TH N AH S
ASKIN/	AH S K IH N
SOLARFLARE	S OW L ER F L EH R
DÆMONS	D M AA N Z
VULNERE	V AH L N AH R
LOGRES	L OW G AH R Z
MOFONGO	M AH F AA N G OW
UNDEFORMED	AH N D IY F AO R M D
GLARINGLY	G L EH R IH NG L IY
STAGGERSTHROUGH	S T AE G ER Z TH R AH F
BEHEMOTHSOF	B AH HH AH M AA TH S AH F
UNWORTHIE	AH N W ER TH IY
CHASTISEMENT	CH AE S T AY Z M AH N T
MORNINGFROM	M AO R N IH N G F R AH M
SEAVENFOLD	S IY V AH N F OW L D
EFTSOONES	EH F T S UW N Z
SSSPERM	S P AH R M
MOORGHAB	M UH R AH B
GEODETIC	JH IY AH D EH T IH K
UNCOMFORTED	AH N K AH M F ER T IH D
OVERMUCH	OW V ER M AH CH
CURVETS	K ER V EH T S
BURGEIS	B AH R JH IY AH S
BOOTSTEP	B UW T S T EH P
SIRED	S AY ER D
CORDUROYS	K AO R D AH R OY Z
NIGHTSHADES	N AY T SH EY D Z
TERRYCLOTH	T EH R IY K L AO TH
ECSTATICS	EH K S T AE T IH K S
POULTRYMEN	P OW L T R IY M EH N
PRÆMIIS	P R M IY AH S
KENNST	K EH N S T
ARÊTE	AA R T
TREACHEROUSLY	T R EH CH ER AH S L IY
MOOMOOOOIF	M UW M UW UW AH F
PERSWASIVE	P AH R S W EY Z AH V
DETRACTION	D IY T R AE K SH AH N
ARBORS	AA R B ER Z
TWOSTEPS	T W AA S T AH P S
WILLOWHERB	W IH L OW ER B
GIRLSSWAGGER	G ER L Z S W AE G ER
SKINYELLING	S K IH N Y EH L IH NG
BARNLIKE	B AA R N L AY K
CONTINUING––COULD	K AA N T IH N UW N G K OW L D
DECRESCENCE	D IY K R EH S AH N S
VODOU	V AA D UW
BREAKFASTED	B R EH K F AH S T IH D
HAMMERINGS	HH AE M ER IH NG Z
SUSPENCE	S AH S AH N S
SHOUTLIGHTNING	SH AW T L AY T N IH NG
136	W AH N TH R IY S IH K S
TRUEI	T R UW AH IY
HERKIMER	HH AH R K AY M AH R
CEAST	S IY S T
ALCHYMIST	AE L CH AH M AH S T
JERKILY	JH ER K IY L IY
GRAEMES	G R IY M Z
SCRUNCHES	S K R AH N CH AH Z
DESSICATION	D EH S AH S EY SH AH N
1884	W AH N EY T EY T F OW R
TRACINGTHE	T R AE S AH N G
WHITEALOOF	W AY T AH L UW F
ASSORTEDRAH	AE S AH R T EH D R AH
RECALLHE	R AH K AE L HH
COMPANIONABLE	K AH M P AE N Y AH N AH B AH L
SHAPESLIKE	SH EY P S L AY K
MEANWHILEMY	M IY N W HH IH L AH M IY
CAVAT	K AE V AH T
HILLSLIKE	HH IH L Z L AY K
RISESI	R IH S AH S IY
PELLENORE	P EH L AH N AH R
W/O	W OW
TORRANT	T AO R AH N T
SITION	S AY SH AH N
MICROREMS	M AY K R AH R EH M Z
ESTEMOS	EH S T AH M AH Z
FÉIN	F IH N
MIGHTINESS	M AY T IY N AH S
GIMBALS	JH IH M B AH L Z
ENTERE	IH N T IH R
TAMERS	T EY M ER Z
SPOILES	S P OW AH L Z
OBELISKS–A	AA B AH L IH S AH
ORONTES	AO R AH N T S
SPOILD	S P OY L D
SCIROCCO	S AH R AA K OW
ROOMTHEN	R UW M TH AH N
ACICULAR	AH S IH S Y AH L AH R
SPRAT	S P R AE T
CRAZYDEUTSCHE	K R AE Z AH D Y UW T S
ENCROACHT	IH N K R OW CH T
WHEATEARS	W IY T IH ER Z
SBLACK	S B L AE K
HAGGED	HH AE G D
INFILES	IH N F AY L Z
ALLFOR	AO L F AO R
FATISCIT	F AH T IH S AH T
GAMESTER	G EY M S T ER
40	F OW R Z IY R OW
HERODOTUS	HH AH R AA D AH T AH S
GREEKSWHERE	G R IY K S W HH AH R
AMEMUS	AE M AH M AH S
***THUS	DH AH S
MAYBACHS	M EY B AH CH S
TIREDIN	T AY ER D IH N
NURSETHE	N AH R S AH DH
KNOWINGNESS	N OW IH NG N AH S
ANTITH	AE N T IY TH
PULSEDT	P UH L S AH D T
TOOK'ST	T UH K S T
KASHMIRTHE	K AE SH M AH R DH
SPRINGE	S P R IH N JH
NOTA	N OW T AH
KURTA	K AH R T AH
ALIF	AE L AH F
FENNY	F EH N IY
TEH	T IY
PLAINT	P L EY N T
RAVENSFROM	R AH V EH N S R AH M
BLINDMAN	B L AY N D M AE N
EMPYREAL	IH M P AY ER AH L
YAQUINA	Y AE K W AH N AH
LUMINESCES	L UW M AH N EH S IH Z
NOYANCE	N OY AH N S
7:02	S EH V AH N Z IY R OW T UW
GROPINGS	G R OW P IH NG Z
FLITTERED	F L IH T ER D
ARISTOGEITON	AH R IH S T AH JH IY T AH N
DIDST	D IH D S T
SEAFOAM	S IY F OW M
CHRYSOPRASE	K R IH S AH P R EY Z
COMMEDIA	K AA M IY D IY AH
TIPSYIS	T IH P S IY IY Z
UNCOMPRISING	AH N K AH M P R AY Z IH NG
PROCLUS	P R AA K L AH S
TRANSFEREES	T R AE N S F ER IY Z
HERSELFTONIGHT	HH AH R S EH L F T AH N AY T
PATCHOGUE	P AE CH AH G
LOBEFOR	L OW B F AO R
MAXIMILLIEN	M AE K S IY M IH L IY AH N
JUSTBEFORE	JH AH S T B IY F OW R
KECOUGHTAN	K EH K AH T AH N
FLÉCHETTES	F L CH EH T S
FISHTAILING	F IH SH T EY L IH NG
FISHBELLY	F IH SH B EH L IY
HELPE	HH EH L P
FUCKINGFAVA	F AH K IH N G F AH V AH
BINDE	B AY N D IY
THROUGHWONDER	TH R AW W AA N D AH R
CATILINE	K AE T AH L AY N
INCOMPREHENSION	IH N K AA M P R IH HH EH N CH AH N
COVEYOUNGISH	K OW V Y AH NG IH SH
AFFORMETH	AE F AO R M AH TH
WEEL	W IY L
WIGGLETAILS	W IH G AH L T EY L Z
MEDICAMENTS	M AH D IH K AH M AH N T S
OLYMPIAOLYMPIA	AH L AH M P IY EY AH L IH M P IY AH
PESTILENT	P EH S T AH L AH N T
ADVENTUREAND	AE D EH N T Y AH R IY N D
YEARSCONSPIRING	Y IH ER Z K AH N S P AY ER IH NG
ALCINOUS	AE L S AH N AH S
DRUNKTHE	D R AH NG K DH
RAMBLAS	R AE M B L AH Z
ENTEREDTHE	IH N T EH R AH D
PALMYRA	P AE L M AH R AH
LIONHOOD	L AY AH N HH UH D
SOLACEWAS	S AH L AE S UW AH Z
GELBES	JH EH L B IY Z
BARWAS	B AA R W AH Z
AFORE	AH F OW R
LAUGHSTEADY	L AE F S T EH D IY
BÉALDATH	B AE L D AH TH
DEADPANPEEVISH	D IY AE D P AH N P IY V AH SH
VERSTÄNDIGEN	V AH R S T N D AH JH AH N
INDIAS	IH N D IY AH Z
TIDESDEATH	T AY D Z D EH TH
FACEBONES	F EY S B OW N Z
WARTRAINS	W AO R T R EY N Z
MOYAL	M OY AH L
VENICES	V IY N AH S
DOLMENSOVER	D OW L M AH N S OW V AH R
THOUGHTSTO	TH AO T S T OW
CHAPATI	CH AE P AH T IY
HOOLLY	HH UW L IY
LOWBALLS	L OW B AO L Z
HANDWORKED	HH AE N D W ER K T
SUCCOURLESS	S AH K AH Y UH R L AH S
MONOTHEISTS	M AA N AH TH IY S T S
STUBBORNED	S T AH B ER N D
HANGERAND	HH AE N JH AH R AH N D
MORNINGSTHIS	M AO R N IH NG Z TH IY Z
O'ERTIRED	AA AH R T AY R D
FINICKING	F AY N IH K S IH NG
IMAGEST	IH M EY JH AH S T
MUEZZINS	M Y UW EH Z AH N Z
CONNUBIAL	K AA N Y UW B IY AH L
MACARONS	M AE K AH R AH N Z
CERTAYNE	S AH R T EY N
MEXICORISING	M EH K S IH K AH R AY Z AH NG
PARENTSMUST	P AH R EH N T S M AH S T
WORDSHARRY	W ER D Z HH AE R IY
TABACO	T AE B AH K OW
COSMICALLY	K AA Z M IH K AH L IY
RASA	R AE S AH
SCRITCH	S K R IH CH
DECEMBERS	D IH S EH M B ER Z
DIMESTORE	D AY M S T OW R
DUSTDEVIL	D AH S T D EH V AH L
MALIE	M EY L IY
ESCAPESO	EH S AE P AH S OW
EXUDATIONS	IH G Z UW D EY SH AH N Z
LETYNGE	L EH T AH N JH
PURS	P AH R Z
T'EFFECT	T EH F AH K T
FLATBUT	F L AE T B AH T
HEIAN	HH IY IY AH N
HOW–WITHOUT	HH OW W AH TH AW T
ANDHOOK	AE N D HH AH K
UNKYNDE	AH N K IH N D
DARKLIGHT	D AA R K L AY T
JUDGMENTALL	JH AH JH M AH N T AO L
NIGHTWARDS	N AY T W ER D Z
KNARRED	N AA R D
FAIRNESSE	F AE AH R N AH S
BRIEFWORD	B R IY F W ER D
PSYCHOTROPIC	S AY K OW T R AA P IH K
HALFWORLD	HH AE F W ER L D
ÉCLAIRCISSEMENT	K L AE AH R S IH S M AH N T
THETONGUE	TH EH T AH NG
BEARDEDFACE	B IH ER D IH D F EY S
WOREAGONY	W OW R AE G AH N IY
24	T UW F OW R
BOOKSEVERYWHERE	B UH K S AH V AH R IH W HH AH R
DECLIVITY	D IH K L IH V AH T IY
UPDATESFROM	AH P D AH T EH S R AH M
DOWNSHIFTED	D AW N SH IH F T IH D
'SURE	S UH R
ITHY	IH TH IY
POINTILLIST	P OY N T IH L IH S T
INTENTWHAT	IH N T EH N T W HH AH T
SITTEN	S IH T AH N
LEASTWAYS	L IY S T W EY Z
MEPRARIE	M EH P R AH R AY
UNGLOSSILY	AH N G L AO S IY L IY
TAV	T AE V
CLAYPATIENT	K L EY P EY SH AH N T
BILLIONFOLD	B IH L Y AH N F OW L D
BLOUDY	B L AW D IY
BOUNCEAT	B AW N S IY T
SMILESATTACHED	S M AY L Z AH T AE CH T
JESTUNTIL	JH EH S T AH N T AH L
PELISSE	P EH L AH S
SAVINGSWHEN	S AH V IH N G S W AH N
STANCHIONS	S T AO N CH AH N Z
CHINSTRAPS	CH IH N S T R AE P S
DOUBLEHOUSE	D AH B AH L HH AW S
COMMETH	K AA M AH TH
SUPERVAGUE	S UW P ER V EY G
TALENTLESS	T AE L AH N T L AH S
ACCLAMATIONS	AE K L AH M EY SH AH N Z
SIGHINGBETTER	S AY IH NG B EH T ER
GUSSETED	G AH S AH T IH D
SHOULDN	SH OW L D N
EXPUNGING	IH K S P AH N JH IH NG
FULKE	F UH K
SURVAY	S AH R V EY IY
STOVETURNED	S T OW V T ER N D
BLOSSOMBLOOMED	B L AA S AH M B L UW M D
MASQUES	M AE S K S
INSTAMATIC	IH N Z T EY M AH T IH K
STARTE	S T AA R T
VOUCHEN	V AW CH AH N
PROWEST	P R OW W EH S T
KHELLA	K HH EH L AH
ONEWILL	AA N Y UW AH L
LOSTFOREVER	L AO S T F ER EH V ER
HUSTLEUPSTREAM	HH AH S AH L AH P S T R IY M
CARILLONS	K AA R IH L AO N Z
BRIARY	B R AY ER IY
UPHEAVE	AH P HH IY V
ZAGREUS	Z EY G R IY AH S
PRIDEBURNING	P R AY D B ER N IH NG
SAVOURIE	S AE V AH R AY
LOVEI	L OW V EY
FILAGREE	F IH L AH G R IY IY
THENAME	TH AH N EY M
FOLIAGED	F OW L IY IH JH D
BEKIESZ	B AH K IY Z
PARVIS	P AA R V AH S
YEARE	Y IY R
DAZD	D AE Z D
BAS	B AE Z
'BOURG/	B OW R G
HANBOKS	HH AE N B AH K S
INTREATED	IH N T R IY T IH D
KNOW'ST	N OW S T
VAPOROUS	V EY P ER AH S
RECEIVD	R AH S IY V D
SLANDROUS	S L AE N D R AH S
NAMETHE	N AE M AH DH
PEBBLY	P EH B AH L IY
EXUBEROUS	IH G Z UW B ER AH S
ROOMFOR	R UW M F AO R
BUBBLESBANG	B AH B AH L Z B AE NG
ANUNECS	AE N Y UW N AH K S
LAVAS	L AA V AH Z
FADELESS	F EY D L AH S
MENISCUS	M AH N IH S AH S
NEOCOLONY	N IY OW K AA L AH N IY
FATTIE	F AE T IY
DAMNÉ	D AE M
HATEN	HH EY T AH N
MONTALE	M AA N T EY L
PRIOCADH	P R AY AH K AH D
FLICKEROUT	F L IH K ER AW T
DELIVERIT	D AH L IH V AH R AH T
LAPSTRAKE	L AE P S T R EY K
QUARRIER	K W AO R IY ER
HALFOF	HH AE L F AH F
SHOALED	SH OW L D
SUCTIONS	S AH K SH AH N Z
PREFERFROM	P R IY F AH R F R AH M
THYROIDS	TH AY R OY D Z
HOUSEFRONT	HH AW S F R AH N T
ROUGHENED	R AH F AH N D
INFOLD	IH N F OW L D
WAYFARERS	W EY F EH R ER Z
SIKEN	S AY K AH N
HUDSONS	HH AH D S AH N Z
SITTE	S IH T
LSCEPTRAL	L S EH P T R AH L
ANAFFABLE	AH N AE F AH B AH L
UNHONORED	AH N AA N ER D
SQUEAKINGS	S K W IY K IH NG Z
PIHA	P IH HH AH
USELESSNESS	Y UW S L AH S N AH S
'ICH	IH CH
STUPIFIED	S T UW P AH F AY D
PÊCHE	CH IY
WADDLES	W AA D AH L Z
FIELDSEXPLORER	F IY L D Z IH K S P L OW R ER
MEANA	M IY N AH
STUCKHER	S T AH K AH R
DEDUSTING	D IY D AH S T IH NG
CORRUGATIONS	K AO R AH G EY SH AH N Z
ZUNNY	Z AH N IY
STITCHTHROUGHHIS	S T IH CH TH R AH F IY Z
AÑIL	EY L
1987	W AH N AY N EY T S EH V AH N
MATINÉE	M AH T AY N
ONBUT	AA N B AH T
BUSYBODY	B IH Z IY B AA D IY
UNPRESAGED	AH N P R EH S IH JH D
BEIGINNING	B AH AH JH IH N AH NG
RENUNCIATORY	R AH N AH N S AY AH T AO R IY
PIERCEST	P IH ER S AH S T
EXPLAINTOTTERIDGE	IH K S L EY N T AA T AH R AH JH
ALTERNATINGLY	AO L T ER N AH T IH NG L IY
QUAECUMQUE	K W IY K AH M K
BECOMETHE	B IH K AH M EH DH
UNPUNCTUAL	AH N P AH NG K CH AH W AH L
FROSTILY	F R AO S T IY L IY
RAPTUR	R AE P T AH R
SUBLIMATING	S AH B L AH M EY T IH NG
SCYTHELESS	S IH DH L AH S
BROWNAS	B R OW N AH Z
NEIGHINGS	N EY AH NG Z
JUDDERING	JH AH D IY R AH NG
SRANNÁN	S R AE N
HAUTEVILLE	HH AO T AH V AH L
BRIAREOS	B R AY AE R IY AH Z
DHRU	D HH R UW
HIPPOGRIF	HH IH P AA G R AH F
FRONDSIN	F R AA N D S AH N
FACTORIZE	F AE K T ER AY Z
UNDA	AH N D AA
SPENTSODDEN	S P EH N T S AA D AH N
SHOESHAPPENED	SH UW Z HH AE P AH N D
GOMBEEN	G AA M IY AH N
DELIS	D IY L AH S
TRAILCIDE	T R EY L S AY D
SINFONIETTA	S IH N F AH N IY T AH
UNDERSTUDYAN	AH N D AH R S T Y UW D AY AH N
FABRICIUS	F AE B R IH S AY AH S
CINEMASCOPE	S IH N AH M AH S K OW P
CREMES	K R IY M Z
JANUARIE	JH AE N Y UW AH R AY
BEASTBODY	B IY S T B AA D IY
THATSEEMINGLY	DH AE T S IY M IH NG G AH L IY
PLEASURING	P L EH ZH ER IH NG
LOTOPHAGITIS	L AA T AH F AH JH AY T AH S
WOBBLERSTHAT	W AA B L AH R S TH AH T
INUTTERABLE	IH N AH T ER AH B AH L
SHETHREW	SH EH TH R UW
GLOVESTHAT	G L AH V AH S T HH AE T
NAMÈD	N AE M D
SEETHY	S IY TH IY
ROMÁN	R AA M
RRAKEHELL	R AE K AH HH AH L
AUDACITIES	AO D AE S AH T IY Z
ASSIZES	AE S AY Z IH Z
BODIESSETTLE	B AA D IY Z S EH T AH L
CARLACUE	K AA R L AH K Y UW
BECOMEANYTHING	B IH K OW M IY N IY TH IH NG
FOREWARND	F AO R UW AH R N D
STONDE	S T AA N D
NOËL	N AA L
THEYDECIDED	TH EY D AH S AY D AH D
CYCLINDRICAL	S IH K L IH N D R IH S AH L
RAFFLED	R AE F L EH D
100S	W AH N Z IY R OW Z IY R OW EH S
SPARROWHAWK	S P AE R OW HH AO K
BEGINSAS	B AH JH IH N S AH Z
SOLIDAT	S AA L AH D AH T
L'HÔPITAL	L HH P IH T AH L
SYNFUL	S IH N F AH L
GETST	JH EH T S T
ITSUSE	IH T S Y UW S
HANDELIAN	HH AE N D IY L IY AH N
OVERSPIRIT	OW V ER S P IH R AH T
ORCIST	AO R S AH S T
PROLIFERATIVE	P R AH L IH F ER AH T IH V
INTERMIXT	IH N T AH R M IH K S T
SIDNEIAN	S IH D N IY IY AH N
WINDIS	W IH N D IY Z
PHILISTINISM	F IH L AH S T IY N IH Z AH M
SUICIDALLY	S UW AH S AY D AH L IY
FLAGELLATION	F L AE JH AH L EY SH AH N
CARÍAS	K AE R AH Z
REPOLARIZE	R IY P OW L ER AY Z
COMBABLE	K OW M AH B AH L
IMPECUNIOUS	IH M P EH K Y UW N IY AH S
EFFORTLESSNESS	EH F ER T L AH S N AH S
WARMTHTHAT	W AO R M TH AH T
RATIONALISTIC	R AE SH AH N AH L IH S T IH K
UNDONETHE	AH N D AA N AH DH
THINGAMMIES	TH IH N G AE M AY Z
EASTERTIDE	IY S T ER T AY D
THERATS	TH IY R EY T S
PREMIÈRE	P R IY M AY R
DOWNTON	D AW N T AH N
TRAITORA	T R EY T AH R AH
CALLÁTE	K AE L T
AUBADE	AH B EY D
PROVENANCEOF	P R OW V AH N AE N S IY AH F
SHEWTH	SH UW TH
TEAPOTS	T IY P AA T S
EA	IY AH
TRINITÀ	T R IH N AH T
ERTHE	AH R DH
WATERSPOUTS	W AO T ER S P AW T S
WINDOWBECAUSE	W IH N D OW B IY K AO Z
SKYDULL	S K AY D AH L
INTRAETHNIC	IH N T R AH EH TH N IH K
TWISTIN	T W IH S T IH N
BRRRA	B R AA
TRANSFUS	T R AE N S AH S
SUSIANA	S UW S IY AH N AH
MOMENTREVEALED	M OW M AH N T R IH V IY L D
TREESAND	T R IY S AE N D
BEACHWARD	B IY CH W ER D
UNLOCATED	AH N L OW K EY T IH D
TOMBLESS	T UW M L AH S
SPINNINGLY	S P IH N IH NG L IY
DELICATESSE	D AH L IH K AH T AH S
UNCONCEIVED	AH N K AH N S IY V D
SOMNOUR	S AA M N AH R
SCYTHÈD	S IH TH D
BOXELDER	B AA K S EH L D ER
71	S EH V AH N W AH N
PONTIFAXIS	P AA N T AH F AE K S AH S
KEEPINGTHE	K IY P AH N G
PIEDMONTOR	P IY D M AA N T ER
CLAMORS	K L AE M ER Z
RYESWAYED	R AY S W EY D
AMAÑÁ	AE M AH
CINTRA	S IH N T R AH
CHEVY/	CH IY V IY
HONNY	HH AA N IY
STIGMATOPHILIA	S T IH G M AH T AH F IH L Y AH
SUITSWALKING	S UW T S W AO K IH NG
WATCHFULLY	W AA CH F AH L IY
ONLYTEN	AO N L IY T EH N
YOURLEGENDS	Y AH R L AH JH AH N D Z
UNDERCREEK	AH N D ER K R IY K
HORNBLOW	HH AO R N B L OW
ARRIVINGBECAUSE	AH R AY V IH NG B IH K AO Z
CLOVERAND	K L AA V AH R AH N D
CONDONABLE	K AH N D OW N AH B AH L
WORNNESS	W OW R N AH S
LEPIDOPTERA	L EH P AH D AA P T AH R AH
UNANCHORED	AH N AE NG K ER D
OVERLANDERS	OW V ER L AE N D ER Z
PAININ	P EY N IH N
PHOTOGRAPHTHE	F AH T AA G R AH F DH
DOUTLESS	D OW Y UW T L AH S
AMONGTHOUSAND	AE M AH N G TH AW S AH N D
BECOMESO	B AH K AH M EH S OW
MARACAIBO	M AE R AH K EY B OW
BEGGING–WOULDN	B IH JH IH N G W OW L D N
INDELIBLEINDELIBLE	IH N D EH L AH B AH L IH N D EH L AH B AH L
PEKOK	P EH K AH K
SHITPILE	SH IH T P AY L
DEFAMING	D IY F EY M IH NG
PIERCINGLY	P IH ER S IH NG L IY
DUNCANUNDER	D AH N K AE N AH N D ER
HEARKENING	HH IH ER K EH N IH NG
DEPENDABLEAND	D AH P EH N D AH B L IY N D
39	TH R IY N AY N
MADRAÍ	M AE D R AH
EPISTEMOLOGICAL	AH P IH S T AH M AA L AH JH IH S AH L
CHARLEVILLE	CH AA R L AH V AH L
PRIVET	P R IH V AH T
PISAN	P AY Z AH N
SCARPS	S K AA R P S
RECALLTHAT	R AH K AE L TH AH T
ECSTACY	EH K S T AH S IY
PUKEARUHE	P Y UW K IY R AH HH
PILIPINAS	P AH L IH P AH N AH Z
FEAR'ST	F IY R S T
TARTRE	T AA R T AH R
TANGY	T AE NG IY
CALQUE	K AE L K
GROVELLER	G R AA V AH L ER
OMENED	OW M AH N D
MEDLY	M IY AH D L IY
HOUSHOLDERE	HH AW SH OW L D AH R
RUN–THE	R AH N DH
DULLARDS	D AH L AH R D Z
EMPRYSE	IH M P R AY Z
PASTIS	P EY S T IY Z
RUBÉN	R AH B N
OVERSCORED	OW V ER S K OW R D
LOVEONE	L OW V IY OW N
ERELONG	EH R AH L AH NG
SUNN	S AH N
OURIE	AH R AY
4TH	F OW R T IY EY CH
ARQUITECTURA	AA R K W AH T EH K T Y AH R AH
RUMSHOP	R AH M SH AA P
–OVERTASKED	OW V ER T AE S K T
FUSILIERS	F Y UW Z AH L IY ER Z
CHINDI	CH IH N D IY
SANDHILLS	S AE N D HH IH L Z
GYMNOPAEDIA	JH IH M N AH P IY D IY AH
THIS/	DH IH S
PLUMCOLORED	P L AH M K AH L ER D
ASKEDFOR	AE S K T F AO R
TRANSFUSES	T R AE N S F Y UW Z IH Z
MICHOACÁN	M AH CH OW K N
RANDVER	R AE N D AH R
SPELLINGSORROW	S P EH L IH NG S AA R OW
WHOSTOLE	HH UW Z T OW L
GUAYAVA	G Y UW EY AH V AH
SNATCHSIDELONG	S N AE CH S AY D L AO NG
ENVYNED	IH N V AY N D
FAYN	F EY N
YOUNOR	Y AW N AH R
VOYAGEONE	V OY EY JH IY OW N
UNPICKED	AH N P IH K T
LUNGFULS	L AH NG F AH L Z
HAPTIK	HH AE P T AH K
EGGLIKE	EH G L AY K
GRENZEN	G R EH N Z AH N
MASTERCRAFTSMAN	M AE S T ER K R AE F T S M AE N
PULLOVERS	P UH L OW V ER Z
MAIMER	M EY M ER
THATNOTHING	TH AE T N AH DH AH NG
CAÑON	K EY AH N
VERGÜENZA	V AH R JH EH N Z AH
CHARLEYCHAPLIN	CH AA R L AH CH AE P L AH N
INVENTERS	IH N V EH N T ER Z
WHITSUN	W IH T S AH N
INNSAND	IH N S AE N D
BODDERI	B AA D AH R IY
ESCUTCHEON	IH S K AH CH AH N
GAUD	G AO D
CAPERING	K EY P ER IH NG
WHENN	W EH N
2PAC	T UW P IY EY S IY
ZYRA	Z IH R AH
SKYSCAPE	S K AY S K EY P
ORATE	AO R EY T
DEARAH	D IY AE R AH
CALENDER	K AH L EH N D AH R
SHIKI	SH IH K IY
ELEOSTEARIC	IY L IY AH S T IY R AH K
UNFELT	AH N F EH L T
CROUCHE	K R AW CH
OVERFRAUGHT	AH V AH R F R AH T
THUMBTACKS	TH AH M T AE K S
BERRIESPULP	B EH R IY Z P AH L P
BLEISTEIN	B L IY S T IY N
EPICUREANS	EH P IH K Y UH R IY AH N Z
PHRASEAS	F R EY S IY Z
LINESTHE	L IH N AH S DH
AURELIA	AH R IY L Y AH
STEAMCLOUDS	S T IY M K L AW D Z
SUNMAN	S AH N M AE N
WEVERIS	W EH V AH R AH S
LACEDAEMONIOS	L AE S AH D AH M OW N IY AH Z
BERIL	B AH R IH L
CRAYONI	K R EY AH N IY
COALMEN	K OW L M EH N
ESSEXAND	EH S EH K S AH N D
CONCEIVINGITS	K AA N S AH V IH N JH AH T S
GOOCOO	G UH K UW
PIFFLE	P IH F AH L
CICATRIX	S AH K AE T R AH K S
PIMENTOS	P AH M EH N T AH Z
DRESSON	D R EH S AO N
WENTIN	W EH N T IH N
BENIND	B AH N AY N D
SIGNOF	S IH G N AH F
'RESEARCHERS	R IY S AH R K AH R Z
RAVENNE	R AE V AH N
TIGRE	T AY G AH R
MOUNTAINED	M AW N T AH N D
RHOMBOIDS	R AA M B OY D Z
ALIVEUNDER	AH L IH V AH N D ER
FENS	F EH N Z
VANISHT	V AE N AH SH T
OBSTRUCTTHE	AA B S T R AH K T DH
WINDOWSWENT	W IH N D OW Z W EH N T
POOLEMAOTIS	P UW L AH M EY AH T AH S
PILSENERS	P IH L S AH N AH R Z
LRIS	L R IH Z
DOIN	D UW IH N
MONARCHIE	M AA N AA R K IY
CITYWARD	S IH T IY W ER D
FOREVERLASTING	F AO R EH V ER L AE S T IH NG
LOGICIANIS	L AA JH AH S IY AH N AH S
CRONES	K R OW N Z
GOTKIDS	G AA T K IH D Z
HEADFULS	HH EH D F AH L Z
REMEDIE	R AH M IY D AY
AMMODYTES	AE M AH D AY T S
GONE11	JH IY OW EH N IY W AH N W AH N
UNPLUGS	AH N P L AH G Z
HV	EY CH V
BIFORN	B AY F AO R N
I'HAD	IH HH AH D
THONK	TH AO NG K
UNREPENTANTLY	AH N R IH P EH N T AH N T L IY
ACRUSTIC	AH K R AH S T IH K
WHITECAPS	W AY T K AE P S
DESCRIED	D IH S R AY D
FRESSH	F R EH S
LIMBEC	L IH M B AH K
GRASSLEANING	G R AE S L IY N IH NG
SZARKOWSKI	S Z AA R K OW S IY
LETTERSAS	L EH T AH R S AH Z
SHRINKTHE	SH R IH NG K DH
THROUGHFOR	TH R AW F AH R
CORDITE	K AA R D AY T
LAMENTATIONSOF	L AH M AH N T EY T IY AA N S AH F
CLASSWHERE	K L AE S W HH AH R
DESTROYEDIS	D IH S T R OY D IY Z
CHAIRBACK	CH EH ER B AE K
DIESER	D AY Z ER
GYTES	JH AY T S
IUELS	AY UW AH L Z
CREAMPASSERSBY	K R IY M P AE S ER Z B AY
DREWTHESE	D R UW TH IY Z
POLESFOR	P OW L Z F AO R
THEMAND	TH EH M AH N D
WECROSS	W EH K R AH S
DISSHEVELD	D IH S EH V AH L D
DIVINETH	D AH V AY N IH TH
TUN	T AH N
EARTHED	ER TH T
HAVEONE	HH EY V IY OW N
CLOAKROOMS	K L OW K R UW M Z
COROLLASBELOW	K OW R AA L AE Z AH L OW
REMEMBERINGONCE	R AH M EH M B AH R IH N G AH N S
MANSHAPE	M AE N SH EY P
TENCE	T EH N S
MOTHERLINESS	M AH DH ER L IY N AH S
GOUDONOVS	G AW D AH N AH V Z
WARRED	W AO R D
CRUZAMOS	K R UW Z AH M AH Z
ROMPED	R AA M P T
MANPOWERED	M AE N P AW ER D
CHUBBS	CH AH B Z
SLUMBRYNGE	S L AH M B R AH N JH
FRANCONIAN	F R AE NG K OW N IY AH N
FORANANGKE	F AO R AH N AH N G K
OUTDAZZLED	AW T D AE Z AH L D
HOEIN	HH OW IH N
GHOSTS/	G OW S T S
MASKOVER	M AE S K OW V ER
STEYLE	S T EY L
BLUEHOT	B L UW HH AA T
UNDISCLOSETHAT	AH N D IH S K L AA Z AH T HH AE T
ROUNDS–ONE	R AW N D S OW N
FLE	F AH L
FIXD	F IH K S D
ARBORED	AA R B ER D
CLORITHA	K L AO R AH TH AH
EXULTATIONOF	IH G Z AH L T AH T IY AH N AH F
ILDEBRANDO	IH L D IY B R AE N D UW
SPEAN	S P IY AH N
HERSELFWITH	HH AH R S EH L F W AH TH
HERACLES	HH EH R AH K AH L Z
CAPTIVED	K AE P T IH V D
SEEMSA	S IY M Z AH
PROTEA	P R OW T IY
PRIESTCRAFT	P R IY S T K R AE F T
JOYND	JH OY N D
LEFTLIVING	L EH F T L IH V IH NG
FOOTSTOOLE	F UW T S T UW L
FORESTTO	F AH R EH S T OW
RAVENTHAT	R EY V AH N T HH AE T
BITTERSOME	B IH T ER S AH M
BEMINIATURE	B IH M IH N IY AH CH UH R
TABULAS	T AE B Y UW L AH Z
OFCONSCIOUSNESS	AA F AA N S IY AW Z N AH S
DECLENSION	D IH K L EH N Z IY AH N
THUNDERLIGHT	TH AH N D ER L AY T
MODERNES	M AA D AH R N Z
ADIEUS	AH D Y UW Z
OTHERWISES	AH DH ER W AY Z IH Z
COFFEE–	K AO F IY
BELFRIES	B EH L F R IY Z
LEADISH	L IY D IH SH
RECONCEIVING	R IY K AH N S IY V IH NG
BACKPORCHES	B AE K P OW R CH IH Z
MANAND	M AE N AH N D
FINGERPADS	F IH NG G ER P AE D Z
WISPINESS	W IH S P IY N AH S
DABS	D AE B Z
PÄRT	P IY AA R T
KISSE	K IH S
RAPTURED	R AE P CH ER D
BOOHOO	B UW HH UW
CORUSCATING	K OW R AH S EY T AH NG
BITUATE	B AY T Y UW EY T
LEAFIT	L IY F AH T
CHESTWHATEVER	CH EH S T W HH AH T IY V AH R
WELLINGTONS	W EH L IH NG T AH N Z
MEMBRA	M EH M B R AH
CORPORALS	K AO R P ER AH L Z
OTHERDEFINING	AH DH ER D IH F AY N IH NG
GATO	G AE T OW
WASWEEKS	W AA S W IY K S
ANDWATCHES	AE N D W AH CH AH Z
DAYGLO	D EY G L OW
WATCHBAND	W AA CH B AE N D
ADVINT	AE D AH N T
OMNIPOTENS	AA M N IH P AH T AH N Z
­–ONLY	OW N L IY
ROSEEARLY	R OW Z ER L IY
CENTERSCAJOLING	S EH N T AH R S AH JH OW L AH NG
ASSAYE	AE S EY
THRACIAN	TH R EY SH AH N
HEROKAY	HH AH R AA K EY IY
CHILDTHE	CH IH L D
1953	W AH N AY N F AY V TH R IY
4:45	F OW R F OW R F AY V
BENTLEYS	B IH N T L EY Z
MIGRATORIUS	M IH G R AH T AO R AY AH S
FOGGING	F AA G IH NG
WAITSON	W EY T S AH N
SEEKETH	S IY K IH TH
GLÜCK	JH IY EH L S IY K
HUNS	HH AH N Z
DAUNTS	D AO N T S
TREASONABLE	T R IY Z AH N AH B AH L
GRAINFIELDS	G R EY N F IY L D Z
TERRIBLEAND	T EH R AH B L IY N D
CIRCUITING	S ER K AH T IH NG
MULTIPLYED	M AH L T AH P L AY D
BELLEROPHON	B IH L EH R AH F AH N
ARMSIS	AA R M Z IY Z
TH'ETERNAL	TH AH T AH R N AH L
POGGIO	P AA JH IY OW
FOLYE	F AA L AY
SWIRLINGDUST	S W ER L IH NG D AH S T
DESDE	D IH S D IY
COUNTERCHARM	K AW N T ER CH AA R M
SCHMUCKS	S K M AH K S
STALKINGJAMB	S T AE L K IH N G AH M
330	TH R IY TH R IY Z IY R OW
CYPRESSES	S AY P R AH S IH Z
SOLANGE	S AA L AH N JH
BÂTI	B T IY
BANJOLELE	B AE N JH AH L IY L
ARCHT	AA R K T
JUTTED	JH AH T IH D
TRAINTO	T R EY N T OW
IKKYPHOSPHORESCE	IH K AH F AA S AH R EH S
LASTTHROUGHITS	L AE S T TH R AW AH T S
PACIENT	P AE S IY AH N T
MAÑANA	M AA N AH
BEFOUL	B IH F AW L
SLINKED	S L IH NG K T
SEABREAM	S IY B R IY M
POTENCIES	P OW T AH N S IY Z
WORKSTHAT	W AH R K S TH AH T
LONGTHIN	L AO NG TH IH N
INFERBUT	IH N F AH R B AH T
BADGERIN	B AE JH ER IH N
CALLOOH	K AE L UW
FREND	F R EH N D
DOWNFOR	D AW N F AO R
BODDICE	B AA D AH S
UPTHRUST	AH P TH R AH S T
ADMIR	AE D M AH R
PREYERES	P R IY Y IY R Z
LAROUSSE	L AH R AW S
ENGRAV	IH N G R AE V
LEOŠ	L IY OW
STRIPPINGS	S T R IH P IH NG Z
VELÁZQUEZ	V EH L Z K W AH Z
UPRIGHTNESS	AH P R AY T N AH S
SHAKENON	SH EY K AH N AO N
HATTWITCHING	HH AE T W IH CH IH NG
BEDD	B EH D
KORE	K AO R
CONTINUOUSCARMEN	K AH N T IH N Y UW AH S K AA R M EH N
SERPENTINED	S ER P AH N T AY N D
PLIGHTED	P L AY T IH D
VAGULA	V AE G Y UW L AH
MATTHEWWHO	M AE T TH UW W HH OW
GUD	G AH D
OSSTED	AA S T EH D
DRYLAND	D R AY L AE N D
BLOD	B L AA D
HERBREATHING	ER B R IY AH TH IH NG
CONCURD	K AH N K ER D
FROXFIELD	F R AA K S IY L D
GUANAJUATO	G Y UW AH N AH JH UW W AH T OW
DAYMAY	D EY M EY
TUNGPO	T AH N G P OW
SLUTTERY	S L AH T AH R IY
PETRAEUS	P EH T R IY AH S
ASPRAMONT	AE S R AH M AH N T
THEYWERE	TH EY W AH R
BONELODGED	B OW N L AA JH D
BEASELY	B AH EY Z L IY
WEIRDED	W IH ER D IH D
156BUT	W AH N F AY V S IH K S B IY Y UW T IY
NOMEN	N OW M AH N
NNAMDI	N AE M D IY
JOSEDISORDERD	JH AA S AH D AH S AO R D AH R D
KNOWINGTHAT	N OW IH N G TH AH T
COCKTEASE	K AA K T IY Z
SAGACIOUSLY	S EY JH AH S IY AH S L IY
PENDULUMS	P EH N JH AH L AH M Z
FLASKET	F L AE S AH T
BURTHENS	B AH R TH AH N Z
SHAPESTHAT	SH EY P AH S T HH AE T
RHODOPE	R AH D OW P
SUCHNOT	S AH K N AH T
BRIDGE/	B R IH JH
UNWOMANLINESS	AH N W UH M AH N L IY N AH S
OCTOROON	AA K T AH R UW N
SEEÄD	S IY D
DIFFIDENTLY	D IH F AH D EH N T L IY
UNCTIONS	AH NG K SH AH N Z
CLAMBERER	K L AE M B ER ER
OÍCHE	AA CH
TRIFLER	T R AY F AH L ER
ELSETIME	EH L S AH T AY M
SEMINOOLE	S EH M AH N UW L
PLACIDITY	P L AE S AH D AH T IY
STENOGRAPHERS	S T AH N AA G R AH F AH R Z
EYEON	AY AO N
HUDDLEDAROUND	HH AH D AH L D AH R AW N D
SOLAZY	S AA L AH Z IY
UNMINDFULNESS	AH N M AY N D F AH L N AH S
A'NT	AE N T
WEYFE	W EY F
NEXTOUR	N EH K S T AH R
STOVEI	S T OW V EY
DAWDLED	D AO D AH L D
KWA	K W AA
STAGEBETWIXT	S T AE JH AH B EH T W AH K S T
2,387	T UW TH R IY EY T S EH V AH N
AIRÀ	EH R
BEDDES	B EH D Z
PALLADIONES	P AE L EY D IY OW N Z
MILKFAT	M IH L K F AE T
BECAUSETHEY	B AH K AO S AH TH IY
JABBERWOCK	JH AE B AH R W AH K
DROPAN	D R OW P AH N
KUMIN	K Y UW M AH N
HEWOULD	HH Y UW OW L D
THOUGHTGRATITUDE	TH AO T G R AE T AH T UW D
PROCRASTINATIONS	P R AH K R AE S T AH N EY SH AH N Z
BRRRAMP	B R AE M P
FILMTHE	F IH L M DH
UNPINCHING	AH N P IH N CH IH NG
RETURNWHOSE	R AH T AH R N W HH OW Z
STIRD	S T AH R D
TRANSVERSALES	T R AE N Z AH R S EY L Z
COMPASSING	K AH M P AH S IH NG
AMONGES	AH M AH NG Z
VOLUNTAD	V AH L AH N T AH D
HEADSARMS	HH EH D Z AA R M Z
WARTHOG	W AO R T HH AA G
YELLOWYELLOW	Y EH L OW Y EH L OW
RESPECTFOR	R IH S P EH K T F AO R
QUOI	K W OY
DIMM	D IH M
TRUFFLED	T R AH F AH L D
CHICKADEES	CH IH K EY D IY Z
SITH	S IH TH
BEHOLDE	B AH HH OW L D
EXISTENCES	EH G Z IH S T AH N S IH Z
DOMELESS	D OW M L AH S
REPORTBUT	R AH P AO R T B AH T
ABNEGATING	AE B N AH G EY T AH NG
IOVE	AY OW V
DISCOLOURATION	D IH S K AH L ER EY SH AH N
INCOMPLICATE	IH N K AA M P L AH K AH T
SOURCED	S OW R S T
8/21	EY T UW W AH N
AMYABLE	AH M AY AH B AH L
TENDERLOINS	T EH N D ER L OY N Z
CLOWNE	K L OW N
GODLINESS	G AA D L IY N AH S
FLOODTIDES	F L AH D T AY D Z
PHILALETHIST	F AH L AE L AH TH AH S T
LIELANGUIDLY	L AY L AE NG G W AH D L IY
SURFACEOF	S AH R F EY S IY AH F
THREADINGTHE	TH R IY D AH N G
BANQUETEERS	B AE NG K W AH T IH R Z
WAVEFORM	W EY V F AO R M
VANNES	V AE N Z
ONEAGLINT	OW N IY G L AH N T
CONQUISTADORS	K AA N K W IH S T AH D AH R Z
TH'OFFENDING	TH AA F EH N D AH NG
SEOYEON	S IY OY IY AH N
COMMONPLACES	K AA M AH N P L EY S IH Z
LETTRES	L EH T AH R Z
LEMSTER	L EH M S T AH R
DEPENDANT	D IY P EH N D AH N T
SUPPURATE	S AH P Y ER AH T
USÁGE	AH Z
ACOMA	AH K OW M AH
CRUISIN	K R UW S AH N
HARUTO	HH AH R UW T OW
ISHMENT	IH SH M AH N T
COPSES	K AA P S IH Z
RAGAZZI	R AH G AE Z IY
PERCEAV	P AH R S IY V
CROSSEDON	K R AO S T AO N
MARSBESEECH	M AA R Z B IH S IY CH
BOGOTÁ	B AA G AH T
PROPOS	P R AA P AA S
SPECHE	S P EH CH
DIBBIK	D IH B AH K
SEVEN…	S EH V AH N
FRIPPERIES	F R IH P AH R AY Z
8,000,000	EY T Z IY R OW Z IY R OW Z IY R OW Z IY R OW Z IY R OW Z IY R OW
'IMMORTAL	IH M AO R T AH L
CORONATIONS	K AO R AH N EY SH AH N Z
GRAVEDIGGER	G R EY V D IH G ER
YAMA	Y AE M AH
QUAK	K W AE K
SWAYBACK	S W EY B AE K
SUPERLOW	S UW P ER L OW
WILLPRIDE	W IH L P R AY D
COLLOQUISTS	K AA L AA K W AH S T S
ANGELOUAND	AE N JH EH L AW AH N D
TOGETHERTHROUGH	T AH G EH DH ER TH R AH F
FARDELS	F AA R D AH L Z
DAYSLONG	D EY Z L AO NG
NOÄKS	N AA K S
HONEYINTO	HH OW N EY IH N T OW
DULNESS	D AH L N AH S
MOCKE	M AA K
TOWHEES	T OW HH IY Z
HEARTLEAP	HH AA R T L IY P
MANTICORE	M AE N T IH K OW R
ABOUTSMOOTHING	AH B AW T S M UW DH IH NG
LYDIAT	L IH D IY AH T
BALMING	B AA M IH NG
DOORMEN	D OW R M EH N
CHHURI	CH HH Y UH R IY
PARLIAMENTAL	P AA R L AH M AH N T AH L
NAIVETEAMATIVE	N AA IY V T IY M AH T IH V
DZIEN	D Z AY AH N
DESTROYSHREWSBURY	D IH S T R OY SH R UW Z B EH R IY
YIREH	Y IH R
DRASTY	D R AE S T IY
HARDWEAPONS	HH AA R D W EH P AH N Z
URGENCE	ER JH AH N S
RIGHTFIGHTING	R AY T F AY T IH NG
PURTY	P AH R T IY
GROWINGUP	G R OW IH NG AH P
SEINTES	S AY N T S
MIDDLEOF	M IH D L IY AH F
BREATHESHEART	B R IY DH Z HH AA R T
SPYDERS	S P IH D AH R Z
SCULLED	S K AH L D
UUUUUUUUUUUUUUXUUUUUUU	Y UW AH UW AH UW AH UW AH UW AH UW AH UW AH K S Y UW AH UW AH UW AH UW
PRÉVERANGES	P R V AH R AE N JH AH Z
VITAMINED	V AY T AH M AH N D
CERTAINLYSUFFICE	S ER T AH N L IY S AH F AY S
VNFORTUNATE	V N F AO R T Y AH N EY T
OPER	OW P AH R
TESTAMENTTO	T EH S T AH M EH N T OW
SAMETHE	S AE M AH DH
TWISTSTHE	T W IH S T S DH
DIVINATIONS	D IH V AH N EY SH AH N Z
PENSIONNAT	P EH N S IY AA N AH T
ERST	AH R S T
MORNING/	M AO R N IH NG
SPRINGBOK	S P R IH N G AH K
PRINCIPALL	P R IH N S AH P AH L
134	W AH N TH R IY F OW R
SEB	S EH B
BEECHES	B IY CH IH Z
VD	V IY D
SHOTGUNLEANED	SH AA T G AH N L IY N D
SHOYEIDO	SH OY IY D OW
GLAMADH	G L AE M AH D
UNRAKED	AH N R EY K T
GOLDENEST	G OW L D AH N AH S T
BEAROR	B AE ER ER
DIAMONDED	D AY M AH N D IH D
FACESOME	F EY S AH M
JIMÉNEZ	JH IH M N AH Z
SPHERING	S F IH ER IH NG
BACKSTEPS	B AE K S T EH P S
GRASSTHE	G R AE S DH
TEENAGES	T IY N IH JH IH Z
SIDESIDE	S AY D S AY D
LEAVED	L IY V D
IEST	Y EH S T
CAMP'D	K AE M P D
CAPTIVITIE	K AE P T IH V AH T AY
…WHEN	W EH N
TAK'ST	T AE K S T
ROUPY	R UW P IY
TONIGHTFOR	T AH N AY T F AO R
ENCUMBERD	IH N K AH M B AH R D
MOSSE	M AA S
PICEOUS	P IH SH AH S
WHERETHEY	W EH R AH TH IY
POET/CRITIC	P OW AH T K R IH T IH K
WEREASLEEP	W IY R IY Z L IY P
TOÄNER	T OW N ER
CARMAGNOLE	K AA R M AH G N OW L
18,000	W AH N EY T Z IY R OW Z IY R OW Z IY R OW
ACCOMPLISHT	AE K AA M P L AH SH T
MOONLIGHTON	M UW N L AY T AO N
DIORAMA	D AY AH R AA M AH
BUGGERED	B UH G ER D
OWRE	OW R
SQUISHES	S K W IH SH AH Z
MAYHAP	M EY HH AE P
ADMONISHÈD	AE D M AH N AH SH D
BOYLIKE	B OY L AY K
CACTUSES	K AE K T Y UW Z AH Z
REORGANISED	R IY AO R G AH N IY Z D
SKIESELATE	S K AY Z IH L EY T
MORNINGSIDE	M AO R N IH NG S AY D
LAIRE	L AE AH R
UNSTOCK	AH N S T AA K
THORNBUSH	TH AO R N B UH SH
BOYOF	B OY AH F
EOLUS	IY AH L AH S
GREENFOREVER	G R IY N F ER EH V ER
FIRESIN	F AY ER S IH N
YARDSI	Y AA R D S IY
OPPROBRIOUS	AA P R AA B R IY AH S
OVERBRANCHING	OW V ER B R AE N CH IH NG
AFFLATUS	AE F L EY T AH S
AUTOMATONS	AO T AA M AH T AA N Z
AKUHLANGA	AE K AH L AE N G AH
ENFOLDETH	EH N F OW L D IH TH
OÖOS	UW Z
AFRAYE	AE F R EY
GUERCINO	G Y UW EH R S AH N OW
NOOKSWITH	N UH K S W IH TH
YAWL	Y AO L
MOMEN	M AA M AH N
SHAME/FAME	SH EY M F EY M
MILESVII	M AH L EH Z IY
ROSESIN	R OW Z S IH N
SAIDST	S EY D S T
EATUNTIL	IY T AH N T AH L
HOLDINGOUR	HH OW L D IH N G AH R
BLÜHN	B IY EH L EY CH N
ALONGATTENDING	AH L AO NG AH T EH N D IH NG
DORMERS	D AO R M ER Z
BILLOWY	B IH L OW IY
REALLYREALLY	R IY AH L AY R IY L IY
TWEAKER	T W IY K AH R
UPHOLSTERER	AH P HH OW L S T ER ER
BLAHBLAHBLAH	B L AE B L AE B L AH
DISTRESSE	D IH S T R EH S
SUMPTUOUSNESS	S AH M P CH AH W AH S N AH S
SPITFALL	S P IH T F AO L
PERITUS	P AH R AY T AH S
INKSPOTS	IH NG K S P AA T S
MINDINTO	M IH N D IH N T OW
WORDE	W AH R D
ABSENTMINDEDLY	AE B S AH N T M AY N D AH D L IY
MANGOMETAPHORS	M AE N G OW M EH T AH F AO R Z
SHIPANU	SH IH P AH N UW
LILYPADS	L IH L IY P AE D Z
EFFROYABLES	EH F R OY AH B AH L Z
KUNWIELDED	K AH N W IY L D AH D
BEVORE	B AH V AO R
LINTY	L IH N T IY
BOTHKNEES	B AA TH N IY Z
DURFOYS	D AH R F OY Z
RUBBISHY	R AH B IH SH IY
BLACKNESSEAT	B L AE K N AH S IY T
ADMINISTRATIONOF	AE D M AH N IH S T R AH T IY AH N AH F
MEXICA	M EH K S AH K AH
SNAILSDEATH	S N EY L Z D EH TH
KAKUTANI	K AE K Y UW T AH N IY
STENCHED	S T EH N CH T
UNFOLLOW	AH N F AA L OW
CARVACROL	K AA R V AE K R AH L
JUDG	JH AH JH
INFUS	IH N F AH S
PROVIDERHE	P R OW V IH D AH R
EYESTHE	EY AH S DH
SPIDE	S P AY D
SHAPINGS	SH EY P IH NG Z
EARACHE	IH ER EY K
PLUMY	P L UW M IY
PENLIGHTS	P EH N L AY T S
RANNOCH	R AE N AH CH
IAL	Y AE L
BOHUNKS	B AA HH AH NG K S
WHEREA	W IY R IY AH
PAISANO	P EY S AH N OW
HACEKS	HH AE S AH K S
ENVYED	EH N V IY D
CONNECTEDBY	K AH N EH K T IH D B AY
PLAIND	P L EY N D
FLOURES	F L OW Y ER Z
BESMOOCHES	B IH S M UW CH IH Z
RABBIE	R AE B AY
OUTBOX	AW T B AA K S
HELPINGWITH	HH EH L P IH NG W IH TH
KILLEDBECAUSE	K IH L D B IH K AO Z
THRALLTO	TH R AE L T OW
STONEIN	S T OW N IH N
CIDERY	S AY D ER IY
BEETLEBACKS	B IY T AH L B AE K S
INFLORESCENCE	IH N F L AH R EH S AH N S
SHILOAH	SH IH L OW AH
BANDANNA	B AE N D AE N AH
UMBACK	AH M B AH K
PASTI	P AE S T IY
MARGHERITA	M AH R EH R AH T AH
BUDDHAA	B AH D HH AH
WEAK–YOU	W IY K AY UW
CHIVALRIE	SH IH V AH L R IY
WATERGATES	W AO T ER G EY T S
CARGAMOS	K AA R G AH M AH Z
BREASTSTROKE	B R EH S T S T R OW K
UNF	AH N F
SYB	S IH B
VAIS	V EY AH S
FERMENTE	F AH R M AH N T
TAPDANCING	T AE P D AE N S IH NG
9/11	N AY N W AH N W AH N
DOPPELGÄNGER	D AA P EH L G NG AH R
TREADETH	T R EH D IH TH
SHOREOF	SH AO R IY AH F
ENTONADOS	EH N T AH N AH D UW Z
SUICIDEYOU	S UW S IH D EY UW
WOLLENE	W AA L IY N
STOUMPERS	S T AW M P AH R Z
DECKETH	D IY S IH TH
YEVE	Y IY V
PARBREAKE	P AA R B R IY K
GIRLSDANCING	G ER L Z D AE N S IH NG
STURDIEST	S T ER D IY AH S T
LIVEIT	L AH V EY T
SOMETHINGSOMETHINGSOMETHING	S AH M TH IH NG S AH M TH IH NG S AH M TH IH NG
LISTOF	L IH S T AH F
STIFFENOR	S T IH F AH N ER
TAIJA	T EY JH AH
CONJECTURED	K AH N JH EH K CH ER D
MANYTHE	M AE N AH DH
HAZED	HH EY Z D
MANTRAS	M AE N T R AH Z
UNPLAYED	AH N P L EY D
HORRIBLEST	HH AO R AH B AH L AH S T
ERRATUM	EH R AH T AH M
BLOTTETH	B L AA T IH TH
DUVETS	D Y UW V AH T S
THANKYOUR	TH AE NG K AY AH R
BISETTE	B AY Z EH T
PERAMBULATE	P ER AE M B Y AH L AH T
BAROUCHE	B AH R AW CH
UED	Y UW T
DOGG	D AA G
TICKLING	T IH K L IH NG
LUCKYSTRIKE	L UW S IY S T R AY K
PLANAND	P L AE N AH N D
RECURSIVELY	R IY K ER S IH V L IY
ARMOURER	AA R M ER ER
BROKEAND	B R OW K IY N D
TORTUREDBY	T AO R CH ER D B AY
THOUSANDYEARS	TH AW Z AH N D Y IH ER Z
VERACIOUS	V AH R EY SH AH S
BENCHE	B IH NG K IY
MOUSELESS	M AW S L AH S
ASPHALTICK	AE S AE L T AH K
EMANCIPATOR	IH M AE N S AH P EY T ER
WARMBREATHS	W AO R M B R EH TH S
ANABRANCH	AH N AE B R AE N CH
MYSTICALBUT	M IH S T AH K AE L B AH T
DEFORESTED	D IY F AO R AH S T IH D
PLANTSTHAT	P L AE N T S TH AH T
GESCHICHTE	JH EH S AH CH T
EGLENTYNE	EH G L AH N T AY N
MUSCOVY	M AH S AH V IY
CASTLED	K AE S AH L D
MARBLY	M AA R B AH L IY
SITU	S IH T UW
VIETFLY	V IY T L IY
WORDIN	W ER D IH N
WRATHIN	R AE TH IH N
DREADETH	D R EH D IH TH
BOATBOTTOM	B OW T B AA T AH M
GUERDOUN	G Y UW AH R D AW N
CONFOUNDIT	K AA N F AW N D AH T
SO4	EH S OW F OW R
THEREWITHALL	TH AH R UW AH TH AH L
COMRADELY	K AA M R AE D L IY
LIGHTON	L AY T AO N
KIMPORTUNE	K IH M P AH R T Y UW N
ORARE	AO R AH R
TRUTHABOUT	T R UW TH AH B AW T
1623	W AH N S IH K S T UW TH R IY
YEUX	Y UW K S
EDGETHE	EH JH AH DH
HYDROCHLORIC	HH IH D R AA K L AH R AH K
CONSTANTINES	K AA N Z T AE N T AY N Z
BLACKCAP	B L AE K AE P
WOOLGATHER	W UH L G AE DH ER
GAMED	G EY M D
TREATERS/	T R IY T ER Z
DEARS	D IH ER Z
PIIS	P AY IY Z
SPEWD	S P Y UW D
DRIPT	D R IH P T
CATLIKEAS	K AE T L AH K IY Z
PRETENDNOT	P R IY T EH N D N AH T
OWNWATER	OW N W AO T ER
SNOWMASS	S N OW M AE S
NICHT	N IH CH T
DEH	D IY
BINGOS	B IH N G OW Z
PERCED	P AH R S T
NEARUNASSAILABLE	N IH ER AH N AH S EY L AH B AH L
WORSTEDE	W AH R S T IY D
LLENARNOS	L AH N AA R N AH Z
NOTHINGMORE	N AH TH IH N G M AH R
LIFEHE	L IH F AH HH
HEAVIED	HH EH V IY D
OTHERDIRECTLY	AH DH ER D AH R EH K T L IY
WATCHFULLER	W AA CH F AH L ER
LAWDIE	L AO D AY
POKEN	P OW K AH N
D9	D IY N AY N
BLACKPOETS	B L AE K P OW AH T S
HOUSESTRELLISEDTRELLISED	HH AW S IH Z T R EH L AH S T R EH L AH S T
DUSTBATHS	D AH S T B AE TH S
SALORE	S AE L AH R
CONVOCATIONS	K AA N V AH K EY SH AH N Z
HEARKEN	HH IH ER K EH N
LIDLESS	L IH D L AH S
PUPPYISH	P AH P IY IH SH
CLENSE	K L EH N S
TAKIS	T EY K IY Z
AIRCLAIM	AH IH R K L EY M
EENSY	IY N Z IY
OUTTOWARD	AW T AH W AO R D
JANGELERS	JH AE N JH AH L AH R Z
RAPALLO	R AH P AE L OW
BUSHFIRE	B UH SH F AY ER
RÉPOND	R P AA N D
WAITEDFOR	W EY T IH D F AO R
PAUVRE	P AO V AH R
DIFFERENTBECAUSE	D IH F ER AH N T B IH K AO Z
UNSACRED	AH N S EY K R AH D
KOSMOS	K AA Z M AH Z
ASHINE	AH SH AY N
SWEATDRIPPED	S W EH T D R IH P T
COURSEIT	K OW AH R S IY T
LAWSIN	L AO S IH N
MAGAZINEBY	M AE G AH Z IY N B AY
SCRIPTCALIBRATING	S K R IH P T K AE L AH B R EY T IH NG
WORLD/WE	W ER L D W IY
SHAPELYAND	SH AH P EH L AY AH N D
ECOD	EH K AH D
CHINDELIBERATELY	CH IH N D IH L IH B AH R AH T L IY
PERIODWE	P AH R AY AH D W
ANOTHERCONCATENATIONOF	AH N AH TH AH R K AH NG K AE T AH N AH T IY AH N AH F
TIMESTHAT	T AY M AH S T HH AE T
FRIGATESFRIGATES	F R IH G AH T EH S R AH G EY T S
YOUAND	Y AW AH N D
WITCHWORK	W IH CH W ER K
WILLHER	W IH L AH R
BIGGERTHAN	B AY JH AH R TH AH N
'WELL	W EH L
SUNGRUNTS	S AH N G R AH N T S
STIRUPS	S T ER AH P S
SPEEDBY	S P IY D B AY
ABBESS	AE B AH S
CAIAPHAS	K EY AH F AH Z
HAMSUN	HH AE M S AH N
AERIALVIEW	AE ER IY AH L V Y UW
RIBBONY	R IH B AH N IY
PROFOUNDAND	P R OW F AW N D AH N D
AWAYAND	AO EY AH N D
UNFASTENED	AH N F AE S AH N D
FRAGS	F R AE G Z
RAPPLE	R AE P AH L
ANALYZETHE	AH N AE L AH Z AH DH
SUMERIAN	S UW M IY R IY AH N
BANZAI	B AE N Z EY
1910	W AH N AY N W AH N Z IY R OW
WÜRFEL	R F EH L
ATTAIND	AE T EY N D
RADIF	R AE D AH F
’	
REMARKSO	R AH M AA R K S OW
DISPERSALS	D IH S P ER S AH L Z
FEATH'RY	F IY TH R IY
COSMOLINE	K AA S M AH L AY N
BONDAD	B AA N D AH D
SCRUBGRASS	S K R AH B G R AE S
CATCHSOME	K AE CH S AH M
SBUSTED	S B AH S T AH D
L'ESCORCE	L EH S AH R S
CHARAXOS	CH AA R AE K S AA S
HARLEYING	HH AA R L EY AH NG
RIDEABLE	R AY D AH B AH L
MOXIBUSTION	M AA K S AH B AH S AH N
SPUDDING	S P AH D AH NG
14:1	W AH N F OW R W AH N
FORMÉD	F AO R M D
BRODSKI	B R AA D S K IY
SEINT	S AY N T
BEHINDNO	B AH HH IH N D N OW
UNCORRECTABLE	AH N K AH R EH K T AH B AH L
SAIDOUR	S EY D AH R
THROUGHPASTURES	TH R AW P AE S T Y AH R Z
AFTERNOONTHE	AE F T AH R N UW N DH
CHROMATIQUE	K R AA M AH T AH K
BROADE	B R OW D
SARPÉDON	S AA R P D AH N
MIGRATINGRAPTOR	M AY G R EY T IH NG R AE P T ER
NOTEABSORBED	N OW T AH B Z AO R B D
SPRINGRESCUES	S P R IH NG R EH S K Y UW Z
INELUCTABLY	IH N IH L AH K T AH B L IY
CHASUBLES	CH AE S AH B AH L Z
OATHAND	OW T HH AE N D
HUMANSTHAT	HH Y UW M AE N S TH AH T
COMPOSTABLE	K AA M P OW S T AH B AH L
MOSSY	M AO S IY
SHOYN	SH OY N
OCARINA	AA K AH R IY N AH
FLAVOUR	F L AE V AH R
GLIÚSCÁIL	G L IH S AH L
SALMANASSAR	S AE L M AE N AH S AH R
WINGTIP	W IH NG T IH P
SHEPHERDE	SH EH F AH R D
FINDA	F IH N D AH
TANGUY	T AE N G AY
HOURSBECAUSE	AW ER Z B IH K AO Z
LOPED	L OW P T
DRERIMENT	D R EH R AH M AH N T
NEARINGMY	N IY R IH N M IY
ENGORGE	EH N G AO R JH
CHION	CH AY AH N
POLLINATORS	P OW L IH N AH T ER Z
MOBB	M AA B
RUPESTRAL	R UW P EH S T R AH L
6:48	S IH K S F OW R EY T
JOSEAVENGEFUL	JH OW S AH V EH NG F AH L
VICISTI	V AH S IH S T IY
EASEFUL	IY Z F AH L
SPOIL…BROUGHTST	S P OY L B R AH T S T
PALEONTOLOGICAL	P EY L AA N T AH L AA JH IH K AH L
DEMIURGE	D AH M AY AH R JH
PORSON	P AO R S AH N
GAUDIER	G AO D IY ER
CALMINGS	K AA M IH NG Z
WHATSOE	W AA T S OW
ALWAYSBORROWED	AE L W EY Z AO R OW D
MYRIADLY	M IH R IY AH D L IY
STEAKLETTE	S T IY K L EH T
BIONIC	B AY AO N IH K
DUNGAREES	D AH NG ER IY Z
MANFUL	M AE N F AH L
ONEIN	OW N IY N
AGUARDIENTEBECAUSE	AE G W AO R D IY N T EH B AH K AH Z
BALACLAVA	B AH L AE K L AH V AH
RILIEVO	R AH L IY V OW
SURPAST	S ER P AE S T
ENGINEPARTS	EH N JH AH N P AA R T S
BETONIES	B IH T OW N IY Z
FLUES	F L UW W Z
REVELINGAND	R AH V AH L IH N G AH N D
ALTERETH	AO L T ER IH TH
CHISTE	CH AY S T
OFFBUT	AA F B AH T
EMBOUCHURES	AA M B UH SH UH R Z
F___	EH F
SLOTKIN	S L AA T K IH N
NEGATIVETONE	N EH G AH T IH V T OW N
FOUNDLINGS	F AW N D L IH NG Z
ARCHIPELAGOES	AA R K AH P EH L AH G OW Z
BIRDI	B AY R D IY
EXPAT	EH K S P AE T
SICKBAY	S IH K B EY
GRAPHING	G R AE F IH NG
VINETO	V IH N AH T OW
RESPECTWHILE	R IH S EH K T W AH L
BAROMETRICALLY	B AE R AH M EH T R IH K AH L IY
DAYROOMS	D EY R UW M Z
PUPAE	P Y UW P IY
WRONGWITH	R AO NG W IH TH
SATIETIE	S AE T IY T AY
TIEAS	T IY AH Z
WANDERYEARS	W AA N D ER Y IH ER Z
SCHOOLGIRLSWITH	S K UW L G ER L Z W IH TH
FLOURSTHAT	F L AH R S TH AH T
ASCENTT	AE S AH N T
FYND	F IH N D
NONES	N AH N Z
MISPLAC	M IH S L AE K
SHADOWWHUMPP	SH AH D OW W HH AH M P
UTOPIAS*	Y UH T OW P IY AH Z
THEACHTAIREACHTA	TH IY CH T AH AH R IY CH T AH
BREASTSTO	B R IY S T S T OW
TRANSAXIAL	T R AE N S AE K S IY AH L
896	EY T N AY N S IH K S
FOISON	F OW IY Z AO N
PROSTITUTED	P R AA S T AH T UW T IH D
FRIZL	F R IH Z L
MISTERLEONARD	M IH S T AH R L IY AH N AH R D
ROSELEAF	R OW Z L IY F
INCORRUPTIBLE	IH N K AH R AH P T AH B AH L
TVIOLENTSTATE	T V AY AA L AH N T S T EY T
DOON	D UW AO N
SKIESSPUN	S K AY AH S P AH N
SAYSFINE	S EY Z F AY N
TOWARDTHE	T OW AH R D
CASTSHER	K AE S T AH R
TYGERS	T IH JH AH R Z
DIGGD	D IH G D
MONKEYDAYS	M AH NG K IY D EY Z
WATERRE	W AA T AH R
SWAINSON	S W EY N S AH N
DOUBLECROSSED	D AH B AH L K R AO S T
DEWSOF	D IH W S AA F
COUNTERACTSBITTERNESS	K AW N T ER AE K T S B IH T ER N AH S
SWLYCÉE	S W L AY S
PENDULIS	P EH N D UW L IY Z
ITSHOULD	IH T OW L D
WHADYA	W AA D AY AH
DVOHISFOOT	D V AA HH AH S UW T
SHUVV	SH AH V
SPRATS	S P R AE T S
OPURAT	AA P Y AH R AH T
LANDSCHAPWITH	L AE N D Z CH AE P W IH TH
DÉBUTANTE	D B Y UW T AH N T
WINGSFLY	W IH NG Z F L AY
RETURNES	R AH T AH R N Z
GLAREFROM	G L AH R EH F R AH M
FITAGAINSTTHE	F IH T AH G EY N S T DH
UNFLAWED	AH N F L AO D
KHAIR	K HH AE AH R
ITDISAPPEARED	IH T D IH S AH P IY R D
NATTERS	N EY T ER Z
RELIEVETH	R IH L IY V IH TH
THRO	TH R OW
EARWAYS	IH ER W EY Z
THOUGHTEN	TH AO T AH N
KANNON	K AE N AH N
PERINEUM	P AH R AH N Y UW M
OPPOSERS	AH P OW Z ER Z
TORTAS	T AO R T AH Z
PLEOCOSTEMUS	P L IY AH K AA S T AH M AH S
STONEGENITALS	S T OW N JH EH N AH T AH L Z
OSIERS	AA S IY ER Z
TIDIES	T AY D IY Z
BOÖTIS	B OW T AH S
MULETEENTH	M Y UW L T IY N TH
WIELDETH	W IY L D IH TH
HEALTHILY	HH EH L TH IY L IY
BUBBLETO	B AH B L AH T OW
BHÉAL	B HH AE L
SCHOOLDESKS	S K UW L D EH S K S
ANATOMYPACKED	AH N AE T AH M IY P AE K T
TEXTTHROWN	T EH K S T TH R OW N
TREEHAS	T R IY HH AH Z
UNAPPROACHED	AH N AH P R OW CH T
FALLINGLIKE	F AO L IH NG L AY K
TREESOVER	T R IY Z OW V ER
PULPED	P AH L P T
MEEKENED	M IY K AH N D
BARABINSKY	B AA R AH B IH N S K AY
DRIVETH	D R AY V IH TH
FLOWRIE	F L OW R AY
GRASING	G R EY Z AH NG
EAGLEDALE	IY G AH L D EY L
AWEWEIGH	AO W EY
PARVE	P AA R V
HOWHOW	HH OW HH OW
SHRIVELL	SH R IH V AH L
NAROPA	N AE R AH P AH
EALLY	IY L IY
PEDAGOGUES	P EH D AH G AA G Z
AUTOEROTIC	AO T OW IH R AA T IH K
LACEWORK	L EY S W ER K
SALTINESS	S AO L T IY N AH S
WAVEAS	W EY V IY Z
EXCELSIS	IH K S EH L Z IY Z
KALAMATA	K AH L AE M AH T AH
DEERS	D IH ER Z
SHOVINGS	SH AH V IH NG Z
LURER	L UH R ER
TOILSOM	T OY L S AH M
CATIONIC	K EY SH AH N IH K
SC	EH S K
GENEROUSIN	JH EH N ER AH S IH N
QUAERITUR	K W IY R AH T AH R
EXEUNT	IH G Z UW N T
COMMERCEHAS	K AA M AH R S AH HH AH Z
TEKHELET	T EH K L AH T
SEEDSWILL	S IY D Z W IH L
SUFFERSTHE	S AH F AH R S DH
INTERESTINGEXCEPT	IH N T R AH S T IH NG IH K S EH P T
GESWICECOCKLEBURS	JH EH S W IH S AH K AA K L EH B Y AH R Z
UNCARVED	AH N K AA R V D
TERCETS	T AH R S AH T S
C18H36O2	S IY W AH N EY T EY CH TH R IY S IH K S OW T UW
PEACHDEATH	P IY CH D EH TH
EATSICKENING	IY T S IH K AH N IH NG
WOLBE	W OW L B
PEACHUMAND	P IY CH UW M AH N D
SPLAKE	S P L EY K
ENDUE	EH N D UW
BECOMFORTABLE	B IH K AH M F ER T AH B AH L
BIRUTLANDSHIRE	B AY R AH T L AE N D SH AY ER
HRHM	EY CH AA R EY CH M
POTIONAT	P OW T IY AH N AH T
IDLEAT	IH D L IY T
CORNBALL	K AO R N B AO L
SATISFYE	S AH T IH S AY
RECLAME	R IH K L EY M
ZENITHIAN	Z AH N IH TH IY AH N
GLIBB	G L IH B
SAUTÉ	S AO T
WOMARA	W AA M AH R AH
REPROACHED	R IH P R OW CH T
ANDI	AE N D IY
/OCHREOR	OW K ER ER
ALDEHYDE	AE L D AH HH AY D
WEAKE	W IY K
LEÄTELY	L IY T L IY
MENE	M IY N
FIDDLEBACK	F IH D AH L B AE K
ELBETO	EH L B AH T OW
OTHERWISEHOW	AA TH AH R W IH S AH HH OW
SETTLEDNESS	S EH T AH L AH D N AH S
SECONDE	S EH K AH N D
AIRSHAFT	AH IH R SH AE F T
GRAVEDIGGERSPALE	G R EY V D IH G ER Z P EY L
BURBS	B AH R B Z
CUTTED	K AH T IH D
THUMPTHUMP	TH AH M P TH AH M P
SNAKE…	S N EY K
SPECKLIKE	S P EH K L AY K
TEÄKE	T IY K
DEERSLAYER	D IH ER S L EY ER
LYFTES	L IH F T S
DIADEMS	D AY AH D AH M Z
LINESFROM	L AH N EH S R AH M
FYNYSTERE	F AH N IH S T AH R
LICKSPITTLE	L IH K S P IH T AH L
GRAFIK	G R AE F AH K
GUTTLING	G AH T L AH NG
METRONOMETRACKING	M EH T R AH N OW M T R AE K IH NG
POW'RFUL	P OW R F AH L
PERCY…	P AH R S IY
ESQUIMAU	EH S W AH M AH
RECURSIVE	R IY K ER S IH V
THIGH/	TH AY
VAR	V AA R
EARTHIS	ER TH IY Z
CREATIONHUMAN	K R IY EY SH AH N HH Y UW M AH N
CHEEVEN	CH IY V AH N
CLYMMYNGE	K L IH M AH N JH
MANILLIO	M AH N IH L IY OW
CLONCAW	K L AO NG K AH
LLAMO	L AE M OW
REGLAR	R EH G L AH R
WHITEHOT	W AY T HH AA T
DUNDY	D AH N D IY
VISUALIZETHE	V IH S W EY L AH Z AH DH
UPTORN	AH P T OW R N
WONYNG	W AA N AH NG
WOMANLESS	W UH M AH N L AH S
MILKWHITE	M IH L K W AY T
FRUITWOOD	F R UW T W UH D
ROLINDA	R AH L IH N D AH
STRATH	S T R AE TH
SNAPBACK	S N AE P B AE K
MEXICANAS	M EH K S IH K AH N AH Z
RUBYES	R UW B AY Z
ENGORGEDGLASS	EH N G AO R JH D G L AE S
PLUMÈD	P L AH M D
STATIONMASTER	S T EY SH AH N M AE S T ER
MANNIKINS	M AE N AH K AH N Z
VINEBURG	V IH N AH B AH R G
PISSAH	P IH S AH
LAVANDE	L AE V AH N D
REMAYNED	R AH M EY N D
UNEARN	AH N ER N
RUNTS	R AH N T S
ORGANISMVOLCANICS	AO R G AH N IH Z AH M V AA L K AE N IH K S
DARK'NEST	D AA R K N AH S T
STARTWATCH	S T AA R T W AA CH
JAWLINED	JH AO L AY N D
ABSCHIED	AE B S K AY D
NIGHT–	N AY T
GALAHADS	G AE L AH HH AH D Z
STOREWITH	S T OW R W IH TH
STATIA	S T EY SH IY AH
CLASSES/	K L AE S IH Z
18TH	W AH N EY T IY EY CH
BEGINNIN	B EH G IH N IH N
FRIARSIN	F R AY ER S IH N
CHIRPER	CH ER P ER
BEATDOWN	B IY T D AW N
REAREDSQUARING	R IY AH R EH D S K W EH R IH NG
WHIRLATOM	W ER L AE T AH M
SEARETH	S IH ER IH TH
NEÆRA	N EH R AH
THIEVESHANGING	TH IY V Z HH AE NG IH NG
RUMDUMB	R AH M D AH M
OVERTHE	AA V AH R DH
MAYAKOVSKY	M EY AH K AA V S K IY
FACEAS	F EY S IY Z
DIVINER	D AH V AY N ER
LOOÖK	L UH K
WOODSTOVE	W UH D S T OW V
WALLFLOWERS	W AO L F L AW ER Z
STARGAZING	S T AA R G EY Z IH NG
PLENIPOTENT	P L AH N IH P AH T AH N T
WINSOMELY	W IH N S AH M L IY
TAFFETAS	T AE F AH T AH Z
TRUCES	T R UW S IH Z
HEATWAVES	HH IY T W EY V Z
APPARATUSWERE	AE P AH R AH T AH S W AH R
EXHILERATING	IH K S IH L AH R EY T AH NG
ERSHADOWING	AH R SH AE D OW AH NG
TIMELESSNESS	T AY M L AH S N AH S
CRESTON	K R EH S T AO N
TOWN/	T AW N
INTACTNESS	IH N T AE K T N AH S
TIDESWEPT	T AY D S W EH P T
BEGONE	B IH G AO N
HEADLONGPHRASESRELIEVED	HH EH D L AO NG F R EY Z IH Z R IH L IY V D
VERMINOUSLY	V AH R M IH N OW AH S L IY
GRACETH	G R EY S IH TH
RANCOROUSLY	R AE NG K ER AH S L IY
COAXESFROM	K OW AE K S EH S R AH M
DISTREST	D IH S T R AH S T
DISTANCEBETWEEN	D IH S T AE N S AH B EH T W IY AH N
COMBUSTIONPHENOMENON	K AH M B AH S SH AY AA N F IH N AA M AH N AA N
3D	TH R IY D IY
CASKETSOF	K AE S EH T S AH F
INCONSEQUENCE	IH N K AA N S AH K W AH N S
SATISFI	S AH T IH S IY
TOPCOAT	T AA P K OW T
JUNKETINGS	JH AH NG K AH T AH NG Z
WONDERLANDED	W AH N D ER L AE N D IH D
DEFIANCES	D IH F AY AH N S IH Z
PRECEPTATRIX	P R IY S EH P T AE T R AH K S
GEATHER	JH IY DH AH R
TAGUS	T EY G AH S
INCONSUMABLY	IH N K AH N S UW M AH B L IY
YEARSTHEY	Y AH R S TH IY
DELIV	D AH L IH V
CONQU'ROR	K AA N K W R AO R
BREADLINES	B R EH D L AY N Z
BOOKWHENEVER	B UH K W HH AH N IY V AH R
MIGHTIN	M AY T IH N
BREASTLESS	B R EH S T L AH S
SÍLE	S AH L
DEVILED	D EH V AH L D
PADAND	P AE D AH N D
ME=GOOK	M IY G UH K
MESKELETAL	M EH S EH L AH T AH L
GOESWHO	G OW EH S W HH OW
GEOGRAPHICS	JH IY AH G R AE F IH K S
PERFORME	P AH R F AO R M
CONTROLLEDSUBSTANCE	K AH N T R OW L D S AH B S T AH N S
SHARPPARTICULAR	SH AA R P AA R T IH K Y AH L ER
NODDLING	N AA D L AH NG
GUZZLED	G AH Z AH L D
SHEFE	SH IY F
BEBOPIST	B IY B AA P IH S T
BERYE	B IH R AY
LIVERPUDLIAN	L AH V AH R P AH D L IY AH N
LEVETH	L IY V AH TH
TACTICSAND	T AE K T IH K S AE N D
WRIGGLED	R IH G AH L D
FACEOF	F EY S IY AH F
METEMPSYCHOSIS	M AH T EH M S AH K OW S AH S
ZERAF	Z EH R AH F
26TH	T UW S IH K S T IY EY CH
DRUDGING	D R AH JH IH NG
DUTCHMEN	D AH CH M EH N
TEMPTERS	T EH M P T ER Z
PRISONERSLIKE	P R IH Z AH N ER Z L AY K
TELEOLOGY	T EH L IY AA L AH JH IY
CIDAH	S IH D AH
IRTY	IH R T IY
XVGOD	Z V G AA D
WHIRRERSOUT	W ER ER Z AW T
BREAKFASTWHERE	B R IY K AE S T W HH AH R
SEEAGAIN	S IY AH G EY N
MUSKOF	M AH S AH F
BYSYDE	B AH S AY D
TOUS	T OW AH S
UNMAKING	AH N M EY K IH NG
JULDEE	JH AH L D IY IY
CANTRAIP	K AE N T R EY P
MAIDENHOOD	M EY D AH N HH UH D
EARTHGOD	ER TH G AA D
BREATHINGAND	B R IY TH IH N G AH N D
PLEYE	P L EY
FAITOUR	F EY T AH R
ODDNCSS	AA D NG K S
GOLIATHIF	G OW L IY AH TH AH F
RÉMY	R M AY
YANKSTHE	Y AE NG K S DH
WELLWITH	W EH L W IH TH
PHYLLYPES	F IH L AY P S
REJOICINGAND	R AH JH OY S IH N G AH N D
HÄLT	EY CH EH L T
EFFECTUAL	IH F EH K CH AH W AH L
CAREWHO	K AH R UW HH OW
JUBILANCE	JH UW B AH L AH N S
KIELBASAS	K IY L B AH S AH Z
OBSTINATELY	AA B S T AH N AH T L IY
WREATHES	R IY DH Z
LUSTERIN	L AH S T ER IH N
CATHOUSE	K AE T HH AW S
PEBBLED	P EH B AH L D
GROVESAND	G R OW V S AE N D
'THIS	TH IH Z
ARMATURES	AA R M AH CH ER Z
EDENI	EH D AH N IY
ACCOMPANI	AE K AA M P AH N IY
UNBLESS	AH N B L EH S
GOLGOTHAS	G OW L G AH TH AH Z
WYNGE	W IH N JH
PICKLETO	P IH K L AH T OW
WOOLPACK	W UH L P AE K
DEFANGING	D IY F AE NG IH NG
ABUTMENT	AH B AH T M AH N T
GART	G AA R T
SHARPAND	SH AA R P AH N D
THOUSANDACRES	TH AW Z AH N D EY K ER Z
FALSEN	F AO L S AH N
CHOLIC	CH AA L AH K
TAUGHTTAUT	T AO T AO T
EARE	IY R
RIGH	R IY
QUERER	K W IY R AH R
HED	HH IY D
MOONCOLOURED	M UW N K AH L ER D
ALIPHATIC	AH L IH P HH EY T IH K
ROOTSPRINGS	R UW T S P R IH NG Z
POETICAL	P OW EH T IH K AH L
PUSCHMAN	P AH S M AH N
CALENDARTHE	K AH L EH N D AH R DH
BEHOVES	B IH HH OW V Z
MORBUS	M AO R B AH S
JACYNTHE	JH AE S AH N DH
ITOLD	AH T OW L D
ACCORDIAN	AE K AO R D IY AH N
EXTERN	EH K S T ER N
AMYOUR	AE M AY AH R
EXPECTEDCONCAVE	IH K S P EH K T IH D K AA N K EY V
KEYBOARD2	K EY IY W AY B IY OW EY AA R D IY T UW
PLAGUY	P L EY G IY
VNKINDLY	V NG K AY N D L IY
UNLOOSEN	AH N L UW S AH N
GREEDINESS	G R IY D IY N AH S
SIZZLES	S IH Z AH L Z
TRANSHUMANCE	T R AE N S HH AH M AH N S
UNALTERING	AH N AO L T ER IH NG
HUKE	HH Y UW K
KINE	K AY N
GOBLINSAND	G AA B L IH N S AH N D
MOCKTHE	M AA K DH
ISHBOSHETH	IH SH B AH SH AH TH
RAIR	R AE AH R
BIRDEVERYTHING	B ER D IY V AH R IY TH IH NG
WOTGOD	W AA T G AH D
SUBORN	S AH B AO R N
COREOPSIS	K OW R IY AA P S AH S
MILKGLASS	M IH L K G L AE S
SLEEPWAS	S L IY P W AH Z
CHIMÆRAS	CH IH M R AH Z
DENOUNC'T	D AH N AW NG K T
RACCOONWAS	R AE K UW N W AH Z
SCAPED	S K EY P T
SHOPIN	SH AA P IH N
CLAMOURS	K L AH M OW Y AH R Z
SPREDS	S P R EH D Z
SINUATE	S IH N Y AH W AH T
STADIUMJUST	S T EY D IY AH M JH AH S T
QUAILING	K W EY AH L AH NG
PAROLEJOHN	P AH R OW L JH AA N
TOKLAS	T AA K L AH Z
HALLELUIAHS	HH AE L EH L UW AH Z
FRONTISPICE	F R AA N T IH S AH S
SWIVELINGCRACK	S W IH V AH L IH NG K R AE K
DROUTHY	D R AW TH IY
MORELS	M AH R EH L Z
BLOODCUP	B L AH D K AH P
WHOP	W AA P
WALS	W AA L Z
ROLEWAS	R AA L UW AH Z
IMPALED/	IH M P EY L D
ZOPHIEL	Z AH F IY L
150S	W AH N F AY V Z IY R OW EH S
BARKOS	B AA R K AA S
DIHEDRAL	D AH HH EH D R AH L
BRASSIERE	B R AH Z IH ER
HOUR/LATE	AW ER L EY T
SHEBANG	SH EH B AH NG
WOULDLACE	W OW L D L AH S
PASSAGEHAPPENS	P AE S IH JH HH AE P AH N Z
FLUKY	F L UW K IY
SKUFFS	S K AH F S
HUMORS	HH Y UW M ER Z
RUFOUS	R UW F AH S
CLEARAND	K L IY R AH N D
ÁLL	EH L
COOLA	K OW AA L AH
NGORONGORO	N G AH R AA N G AH R OW
THISAIMED	DH AY Z EY M D
BEAUS	B OW Z
UNDIVINING	AH N D AH V AY N IH NG
CLOUDOF	K L AW D AH F
INFLUENCINGS	IH N F L UW AH N S IH NG Z
LÜNEBURG	L N EH B AH R G
CARTLOAD	K AA R T L OW D
SATEEN	S EY T IY AH N
MÉRIDA	M R IH D AH
EXCURSIONIST	IH K S K ER ZH AH N IH S T
ANTIPHONARY	AE N T AY F OW N EH R IY
PONTING	P AA N T AH NG
RANKAND	R AE NG K AH N D
SAIDMY	S EY D M IY
EYESONLY	AY S AH N L IY
RYME	R AY M
BOWRES	B OW R Z
POOSH	P UW SH
UNESPIED	AH N EH S AY D
PARTIALS	P AA R SH AH L Z
KYNG	K IH NG
LUHADOBELL	L AH HH AE D AH B AH L
DARTMOOR	D AA R T M UH R
BOOLD	B UW L D
HORAS	HH AO R AH Z
MILLENIUM	M IH L IY N IY AH M
LESSENER	L EH S AH N ER
SHRILLING	SH R IH L IH NG
ARMLOAD	AA R M L OW D
SUBTERFLUOUS	S AH B T AH R F L Y AH W AH S
OPINIONSBFOCI	AA P AH N IY AA N S B F AH S IY
BETWEENLADDERS	B IH T W IY N L AE D AH R Z
WAYTHEY	W EY TH IY
HUFEISEN	HH Y UW F IY AH S AH N
DOWEROF	D OW AH R AH F
CONTRAPPOSTO	K AA N T R AE P AA S T OW
TAKESHIM	T EY K SH IH M
HAIRIN	HH EH R IH N
ONLYHICK	AO N L IY HH IH K
FORTIFIES	F AO R T EY AH F AY Z
AMORISTS	AE M AH R AH S T S
DOWNHILLUNDER	D AW N HH IH L AH N D ER
METHUSELAHS	M AH TH UW S AH L AH Z
WAYJESUS	W EY JH AH Z AH S
LEEPS	L IY P S
PAULLES	P AO L Z
CHALIAPIN	CH EY L IY AH P AH N
JOTTINGS	JH AA T IH NG Z
MEMNONIAN	M EH M N OW N IY AH N
PORTICOES	P OW R T IH K OW Z
FURDER	F AH R D AH R
EVERYBUTTON	IY V AH R IY B AH T AH N
KINDTHAT	K IH N D TH AH T
WEIGHTIER	W EY T IY ER
CUPFUL	K AH P F UH L
OSSEOUS	AA S IY AH S
STROD	S T R AA D
RICHMONDTOWN	R IH CH M AH N D T OW N
MUSS	M AH S
MOREMISTRESSES	M AO R AH M IH S T R EH S AH Z
PROXIMITIES	P R AA K S IH M AH T IY Z
RODEAMONG	R OW D IY M AH NG
EMY	IY M IY
CROAKED	K R OW K T
WHATCHAMACALL	W AH CH AE M AH K AH L
SAGALAND	S AA G AH L AE N D
ARGUFY	AA R G Y UW F IY
ENKINDLE	EH N K IH N D AH L
SUGARTONGUE	SH UH G ER T AH NG
TONGUING	T AH NG IH NG
ASCETICAND	AE S EH T AH K AH N D
COURT–	K OW R T
ZAVEN	Z EY V AH N
HEEDLESSLY	HH IY D L AH S L IY
MOARIE	M OW R AY
GLINTLIKE	G L IH N T L AY K
SAFETIE	S EY F T AY
MERRIWETHERAN	M EH R AH W EH TH AH R AH N
WISINTERKNIT	W IH S AH N T AH R K N AH T
KOJO	K OW JH OW
HATSHELF	HH AE T SH EH L F
FORGETE	F AO R JH IY T
DIVERTER	D AY V ER T ER
CEREMONIOUS	S EH R AH M OW N IY AH S
ANARCHIES	AE N ER K IY Z
DZOGBESE	D Z AA G IY Z
DUSKHUGE	D AH S K HH Y UW JH
DREAR	D R IH ER
SWEATWATERED	S W EH T W AO T ER D
BEBOPPING	B IY B AA P IH NG
USMIGHT	AH Z M AY T
AMBULATOR	AE M B Y AH L AH T ER
NAPOLÉON	N AE P AH L AH N
SESUN	S EH S AH N
JERBOA	JH AH R B OW AH
DS	D IY S
261	T UW S IH K S W AH N
SHAPESARE	SH AE P AH S AH R
LEPANTO	L AH P AE N T OW
LIGHT/BELIEVE	L AY T B AH L IY V
CLAUSTRAL	K L AO S T R AH L
ONEMADE	AA N AH M EY D
TRUNCK	T R AH NG K
LIKEWHAT	L IH K Y UW HH AH T
CHRISTOS	K R IH S T AH Z
VOCIFERATIONS	V AA S AH F AH R EY T IY AH N Z
RATAFIE	R AH T EY F AY
DEPARTE	D AH P AA R T
INSOFARIAN	IH N S AH F EH R IY AH N
ABLUTIONS	AE B L UW T IY AH N Z
MISSOLONGHI	M IH S AA L AH N IY
BANDAGING	B AE N D IH JH IH NG
SOPOWERFUL	S AA P OW ER F AH L
STITCHIN	S T IH CH IH N
COLLOQUIALISM	K AH L OW K W IY AH L IH Z AH M
RAÄVED	R EY V D
HEREDITARIE	HH AH R EH D AH T ER IY
CXXXV	S IY EH K S EH K S EH K S V
LOQUATS	L AA K W EY T S
ECTOTHERMIC	EH K T AH TH AH R M AH K
NASIRIYAHWERE	N AH S IH R IY AY AE W AH R
DEYNTEES	D IY Y N T IY Z
TARROCKS	T AA R AA K S
LOOKEDAS	L UH K AH D AH Z
HEI	HH IY
TRIFLERS	T R AY F AH L ER Z
OFLAC	AA F L AH K
INVARIOUS	IH N V EH R IY AH S
KNEADS	N IY D Z
ANIMALDROPS	AE N AH M AH L D R AA P S
MYLD	M IH L D
ANNULLING	AE N AH L AH NG
GERMANSINVADED	JH ER M AH N Z IH N V EY D IH D
WAYWOMEN	W EY W IH M AH N
ELATREUS	AH L AE T R IY AH S
MADETOGETHER	M EY D T AH G EH DH ER
HURI	HH Y UH R IY
ATTEMP'RING	AE T EH M P R AH NG
TOTONACS	T AA T AH N AH S
ANDSOUND	AE N D S AW N D
CRACKLINGS	K R AE K L IH NG Z
VERD	V AH R D
FREE/CALL	F R IY K AO L
HEADOF	HH IY D AH F
BLEACHI	B L IY CH IY
ROCKSBEFORE	R AA K S B IH F OW R
PLOPPING	P L AA P IH NG
PILGRIMES	P IH L G R AY M Z
PARACLETE	P AE R AH K L IY T
ELIMINANDS	AH L IH M AH N AH N D Z
COURTROOMTHAT	K OW AH R T R UW M TH AH T
RAPPLEIT	R AE P L IY T
HUKVALDY	HH AH K V AE L D IY
DANDLES	D AE N D AH L Z
LYIN	L AY AH N
HULLES	HH AH L Z
AMBROTYPES	AE M B R AH T AY P S
'OLD	OW L D
YOU­PROOF	Y UW P R UW F
PARRICIDES	P AE R AH S AY D Z
WRONGWAY	R AO NG W EY
INVULNERABLETO	IH N V AH L N AH R AE B L AH T OW
ABSTENTIA	AE B S T EH N CH IY AH
BROTHERED	B R AH DH ER D
EMBALMER	IH M B AA M ER
STRAYNED	S T R EY N D
PEDANTICALLY	P AH D AE N T IH K AH L IY
GONE…	G AO N
DOWNTURNED	D AW N T ER N D
GRAYSIN	G R EY S IH N
RENNES	R EH N Z
BREATHHIS	B R EH TH IY Z
MEDITATED	M EH D AH T EY T IH D
DAUNCING	D AO N S AH NG
UNCOURTEOUSLY	AH N K ER T IY AH S L IY
YESS	Y EH S
VILLANELLE	V IH L AH N AH L
ENWRAP	EH N R AE P
HUHUHU	HH AH HH AH HH UW
FLOURESPIRITS	F L OW Y ER S P IH R AH T S
LEAVESSCALDED	L IY V Z S K AO L D IH D
SHIRTWAISTS	SH ER T W EY S T S
BREATHEHIS	B R IY TH AH AH S
FLUFFILY	F L AH F IY L IY
LIFEIN	L AY F IH N
BONYFINGERS	B OW N IY F IH NG G ER Z
COLERDIGE	K OW L AH R D AY JH
FIRSTROSE	F ER S T R OW Z
ONCETHEY	AA N S AH TH IY
MIMOSAS	M IH M AH S AH Z
WOLSELEY	W OW L S IY L IY
SHUS	SH AH Z
CAMARONES	K AE M AH R OW N Z
LOUTISHNESS	L AW T IH SH N AH S
SJ	EH S JH
UNDERWEARS	AH N D ER W AE ER Z
CHESED	CH S T
UPTO	AH P T OW
655,000	S IH K S F AY V F AY V Z IY R OW Z IY R OW Z IY R OW
EPT	EH P T
KEYSPEACH	K IY Z P IY CH
SILVERO	S IH L V AH R OW
DITTIE	D IH T AY
¿HAVE	HH AE V
'ER	EH R
SEIMINT	S AY M AH N T
BEDROLL	B EH D R OW L
LOGMY	L AA M IY
AMASSINGNINETY	AH M AE S IH NG N AY N T IY
FETISLY	F EY T IY Z L IY
HARDIHOOD	HH AA R D IY HH UH D
REARRIVAL	R IY AH R AY V AH L
CATGUT	K AE T G AH T
YEWS	Y UW Z
WORMWARD	W ER M W ER D
NIGHTÈS	N AY T S
DISCOVERA	D IH S AH V EH R AH
LORD/LESS	L AO R D L EH S
STREGA	S T R EH G AH
SILENCEWALKING	S AY L AH N S W AO K IH NG
PATOF	P AE T AH F
LETHALMOST	L IY TH AH L M OW S T
DURELESS	D UH R L AH S
MEMPHREMAGOG	M EH M F R EH M AH G AH G
LAB'RING	L AE B R IH NG
PUESTA	P Y UW EH S T AH
CAROWE	K AA R OW
DEPRESSORS	D IY P R EH S ER Z
SEMBLÉ	S EH M B L
CHICKENPOX	CH IH K AH N P AA K S
TREESUNSEENIT	T R IY S AH N S IY N AH T
YELLOWTHAT	Y EH L OW TH AH T
REACHLESS	R IY CH L AH S
77	S EH V AH N S EH V AH N
REPLYES	R EH P L AY Z
PÂTISSERIE	T IH S IY R AY
INSCRUTABLY	IH N S K R UW T AH B L IY
FLOWERBEDS	F L AW ER B EH D Z
WINDBLOWN	W IH N D B L OW N
MIRABEAU	M AH R EY B IY UW
SEAMED	S IY M D
TRENCHING	T R EH N CH IH NG
PASSCHENDAELEONTO	P AE S AH N D IY L IY AA N T OW
REALIZELIFE	R IY L AY Z L AY F
UNABSOLUTE	AH N AE B S AH L UW T
DJUNA	JH UW N AH
TIMETO	T IH M AH T OW
SIZEAND	S AH Z IY N D
HEDGEHOGSOMEWHERE	HH EH JH AH HH AA G S AH M Y UW HH AH R
UNDERWAYWHATEVER	AH N D AH R W EY W HH AH T IY V AH R
WAXTO	W AE K S T OW
UNCOMPLAINING	AH N K AH M P L EY N IH NG
HOBAB	HH AA B AH B
CAIQUITO	K EY K W AH T OW
TRIGGERFISHAND	T R IH JH AH R F AH SH AH N D
BACKPIECE	B AE K P IY S
AERIALIST	AE ER IY AH L IH S T
ANTSTO	AE N T S T OW
LANCASTRIANS	L AE NG K AE S T R IY AH N Z
OVERSWEEP	OW V ER S W IY P
FEETSAILMAKERSTITCHES	F IY T S AH IH L M EY K ER S T IH CH IH Z
VIZHA	V IH Z HH AH
DEBARS	D IY B AA R Z
INDURANCE	IH N D UH R AH N S
CATARACTING	K EY T ER AE K T IH NG
BLINDNESSIN	B L AY N D N AH S IH N
PROMULGATORS	P R AA M AH L G EY T ER Z
DOTARD	D AA T AH R D
UNDIVERTED	AH N D AY V ER T IH D
ENTHRALL'D	IH N TH R AE L D
GAH	G AE
PRATIS	P R EY T AH S
HYEAHS	HH AY IY Z
DIETED	D AY AH T IH D
LYNEN	L AY N AH N
FOURSCOOR	F AH R S OW AH R
ULTRASUEDE	AH L T R AH S UW AH D
EXTRAVAGANCES	IH K S T R AE V IH G AH N S IH Z
O'ERWHELMS	AH AH R W HH AH L M Z
POILU	P OY L UW
SILENTIN	S AY L AH N T IH N
VERNYCLE	V AH R N AH K AH L
LOOKEDUPON	L UH K T AH P AO N
GISMOND	JH IH Z M AH N D
LEPROSARIUM	L EH P R AH S AE R IY AH M
ALLELUYA	AE L AH L UW W AY AH
RECEYVE	R AH S EY V
RATLESS	R AE T L AH S
ASYLYMS	AE S AH L AH M Z
BACKSEATOF	B AE K S IY T AH F
CLIFFAND	K L IH F AH N D
OFBLUE	AA F B L UW
DOOMD	D UW M D
BAGSAND	B AE G S AE N D
IDEATIONALCHAUVINISTS	AH D AH T IY AH N AH L CH AO V AH N AH S T S
ARGOTSO	AA R G AA T S OW
CHARIOTER	CH AE R IY AH T ER
CHIMERIC	CH AY M ER IH K
MELTER	M EH L T ER
NOWSNAGGEDON	N AW Z N AE G D AO N
MCWILLIE	M K W IH L AY
COPPERED	K AA P ER D
EPHAH	EH F AH
BISABUELA	B AY S AE B Y UW AH L AH
CAMELSTHOUGH	K AH M EH L S TH UW
PEERE	P IH R
FULLBLOWN	F UH L B L OW N
CANDLEFLAME	K AE N D AH L F L EY M
HUGMUGOO	HH AH G M Y UW G UW
SHOPPERSSPILL	SH AA P ER Z S P IH L
GIUSTS	JH AY AH S T S
THYTHER	TH IH DH AH R
WINDTHEN	W IH N D TH AH N
HET	HH EH T
ASCAIRT	AE S AH AH R T
HICKOCK	HH IH K AH K
NENVIE	N EH N V AY
RAMPED	R AE M P T
ANNOYANCER	AH N OY AH N S ER
DITCHBANK	D IH CH B AE NG K
SEARCHIN	S IH ER CH IH N
CARDFOR	K AA R D F AO R
THIS/THATFROM	DH IH S TH AE T R AH M
POWRES	P OW R Z
VOO	V UW
UNSUCKT	AH N S AH K T
CALL'DRAPHAEL	K AE L D R AH F IY L
INDIASTREAMS	IH N D IY AH S T R IY M Z
BUTTERFLIED	B AH T ER F L AY D
BLOOMINGINTO	B L UW M AH N JH IH N T OW
FROO	F R UW
AWNED	AO N D
SCRIBBLY	S K R IH B AH L IY
THUND'ROUS	TH AH N D R AH S
SASKA	S AE S AH
VIBRATIONAL	V AY B R EY SH AH N AH L
MUMMYNGE	M AH M AH N JH
CARTAGE	K AA R T IH JH
ANTIPERSPIRANT	AE N T AY P ER S P AY R AH N T
THINGTHE	TH IH N G
UP/	AH P
CHRISTABEL	K R IH S T AH B AH L
UNBLAMED	AH N B L EY M D
MUCKLUCKS	M AH K L AH K S
SOMECOMPLETE	S AH M EH K AH M P L IY T
MAVOURNEEN	M AH V OW R N IY AH N
WRAPPEDMYSELF	R AE P EH D M AH S EH L F
SAMAD	S AE M AH D
PREFOSSIL	P R IY F AA S AH L
NATION/	N EY SH AH N
MIMES	M AY M Z
WAKINGUP	W EY K IH NG AH P
REMOOV	R AH M UW V
ADVANC'T	AE D AH NG K T
SCHOOLIN	S K UW L IH N
TIMEIN	T AY M IH N
CURRITUCK	K AH R AH T AH K
SÍ	EH S
SOLEMNEST	S AA L AH M AH S T
VAUNTIE	V AO N T AY
WESTENE	W EH S T IY N
ALBUMENCONCENTRATE	AE L B AH M AH N K AA N S AH N T R EY T
WAÄSTE	W EY S T
MELLOWNESS	M EH L OW N AH S
BLAWS	B L AO Z
DECEIVER	D IH S IY V ER
USHIS	AH SH AH S
JABBERED	JH AE B ER D
RESOUN	R AH S AW N
SURVEYEST	S ER V EY AH S T
DOUBTLESSLY	D AW T L AH S L IY
PERPIGNAN	P AH R P IH G N AH N
AUPRÈS	AO P R Z
SAPLESS	S AE P L AH S
UNZUNN	AH N Z AH N
MYS	M AY Z
MATINS	M AE T AH N Z
SEELDOM	S IY L
DONEFOR	D AH N F AO R
INTERVALED	IH N T ER V AH L D
T'INSTRUCT	T IH N S T R AH K T
ABBADABBA	AE B AH D AE B AH
ALACK	AH L AE K
HEATE	HH IY EY T
BIENVENIDOS	B AY AH N V EH N AH D AH Z
RAISEDON	R EY Z D AA N
RESEEN	R IY S IY N
POSSESSEDOF	P AA S EH S AH D AH F
ACUERDAS	AE K Y UW EH R D AH Z
SLANTINGA	S L AE N T IH N G AH
DIDWAS	D IH D W AH Z
1927–2017	W AH N AY N T UW S EH V AH N T UW Z IY R OW W AH N S EH V AH N
PLACERVILLE	P L AH S AH R V AH L
REDLY	R EH D L IY
SEASHINES	S IY SH AY N Z
SAIDIN	S EH D IH N
REDEEMD	R IH D IY EH M D
WENEED	W IY N IY D
WASCHING	W AA S AH NG
HEAVENNE	HH IY V AH N
CONSOLARSE	K AA N S AA L AH R S
CHAWIN	CH AO IH N
PLINII	P L IH N IY
NORHOPE	N AH R OW P
'ERSE	AH R S
STICKINESS–	S T IH K IY N AH S
DISPUTEM	D IH S Y UW T AH M
ADDORNE	AE D AH R N
LAUTERBOURGFROM	L AO T AH R B AH R G F R AH M
PASSEGGIATA	P AE S AH JH IY AH T AH
ERWATCHED	AH R W AH CH T
CONSONANCE	K AA N S AH N AH N S
LOOKETH	L UH K IH TH
LOVEST	L AH V AH S T
GROTTES	G R AA T S
AMONGARGYLE	AH M AA N G AH R JH AY L
VINO	V IH N OW
ROBINSARE	R AH B IH N S AH R
SWERED	S W IY R D
CLIFFSNOTES	K L IH F S N OW T S
WAYSTHE	W EY S DH
VENTUROUS	V EH N CH ER AH S
ZOPILOTES	Z AA P AH L OW T S
PLACEELSEWHERE	P L EY S IY L S UW HH AH R
GENNEP	JH EH N AH P
MOUSTACHIOED	M AW S T AE CH IY OW D
OUTFROM	AW T F R AH M
'SITTING	S IH T AH NG
KENE	K IY N
WHENTHE	W EH N DH
WONDEREDWHERE	W AA N D AH R EH D W HH AH R
AIEEEEEEEE	EY IY IY IY IY IY
SUBLIMING	S AH B L AY M IH NG
ASSAYING	AE S EY IH NG
212	T UW W AH N T UW
GLASSIFIED	G L AE S AH F AY D
DEAFNING	D IY AE F N AH NG
TUSSIS	T AH S AH S
RUCTION	R AH K AH N
FELLSO	F EH L S OW
EMPTYPIT	EH M P T IY P IH T
OFDECORUM	AA F D EH K AH R AH M
SWIGGLE	S W IH G AH L
HOBBINOLLS	HH AA B AH N AH L Z
TIMBALLO	T IH M B AE L OW
CHANGEDSO	CH AE N JH EH D S OW
HIGHABOVE	HH AY AH B AH V
WHITEFELLAS	W IH T AH F EH L AH Z
CRISEYDE	K R AH S EY D
OBAYDE	AH B EY D
THEYSTILL	DH EY Z T IH L
SWEETLIPPED	S W IY T L IH P T
ÁLVARO	L V AE R OW
TEATIME	T IY T AY M
GENUFLECTS	JH AH N AH F L AH K T S
GOSHKITCH	G AA SH AH CH
MIMMING	M IH M AH NG
UNTWIRL	AH N T W ER L
HUSBANDLED	HH AH Z B AH N D L EH D
TASTETH	T EY S T IH TH
HOMEMY	HH AA M AH M IY
SKANKING	S K AE NG K AH NG
MORTIFIE	M AO R T AH F AY
SETHTHE	S EH TH DH
ZERMATT	Z AH R M AH T
NOTAS	N AA T AH Z
COUNTERTURN	K AW N T ER T ER N
LIBERATES	L IH B ER AH T S
UKNOWNE	AH K N OW N
SPEAKAND	S P IY K AH N D
VOLE	V OW L
URASHIMA	Y AH R AE SH AH M AH
LEVIATHANS	L IY V IY AH TH AH N Z
MAIDENHAIR	M EY D AH N HH EH R
WAYGOD	W EY G AA D
HAVERGAL	HH AH V AH R G AH L
SUNBOX	S AH N B AA K S
WEHADN	W EH HH AH D N
APPAL	AE P AH L
ANTLIKE	AE N T L AY K
MARBLEFACT	M AA R B AH L F AE K T
ALLBUT	AE L B AH T
CLANSMAN	K L AE N Z M AE N
WILLIAMSHASN	W IH L IY AE M SH AH Z N
MINDSPEAKER	M AY N D S P IY K ER
DEATHBELL	D EH TH B EH L
REWE	R AH W IY
LUCIDITIES	L UW S IH D AH T IY Z
HEADSHAVE	HH EH D SH EY V
WALLSTHE	W AA L S DH
HOLEIN	HH OW L IH N
ALPHEI	AE L F IY
WIGGED	W IH G D
PICARESQUE	P IH K AH R EH S
DRYNKERS	D R IH NG K AH R Z
TORNDEAR	T OW R N D IH ER
EQUIPPER	IH K W IH P ER
WALLAHI	W AA L AH HH IY
DIRTCOFFEE	D ER T K AO F IY
EVALUATIVE	IH V AE L Y AH W EY T IH V
CLOATHD	K L OW TH D
AXETH	AE K S IH TH
MINGL	M IH N G L
LOCHIA	L AA CH IY AH
WYRD	W AH R D
36TH	TH R IY S IH K S T IY EY CH
INSUFFICIENCY	IH N S AH F IH SH AH N S IY
LOOKTO	L UH K T OW
BEARST	B AH AA R S T
WITHHALF	W IH TH HH AE F
MEDLED	M IY D L EH D
FOLKSWHO	F OW L K S W HH OW
TREED	T R IY D
CORRUGATEDTIN	K AO R AH G EY T IH D T IH N
MA*YA	M AA Y AA
DISSWADES	D IH S W EY D Z
TIMEWAS	T IH M Y UW AH Z
MAELSTROMOF	M IY L S T R AH M AH F
TENDERAND	T EH N D AH R AH N D
NÁHUATL	N HH Y UW AH T L
UNTA	AH N T AA
WORLD…THEN	W ER L D TH AH N
DISIDENTIFICATION	D IH S AY D EH N T AH F AH K EY SH AH N
CHICKADEE	CH IH K EY D IY
F14	EH F W AH N F OW R
COULD…	K UH D
THEDREAM	DH AH D R IY M
LORDLINGS	L AO R D L IH NG Z
WAVILY	W EY V IY L IY
LISTE	L AY S T
WATERLILIES	W AO T ER L IY L IY Z
FOLLOWIN	F AA L OW IH N
BONCHEDE	B AO NG K IY D
FRUITILY	F R UW T IY L IY
EYES–	AY Z
PIÑATAS	P AY AH T AH Z
CROTCHES	K R AA CH AH Z
THEREFORENO	TH EH R AH F AO R AH N OW
SQUANTO	S K W AA N T OW
SHEARLING	SH IH ER L IH NG
GETUP	G EH T AH P
SUBSISTS	S AH B S IH S T S
DUSTAGAINST	D AH S T AH G EY N S T
SHARETHE	SH AE R AH DH
AWAYAS	AO EY AH Z
DISJOYNING	D IH S JH OY N AH NG
CLOCKMAKER	K L AA K M EY K ER
SNOWIT	S N OW AH T
BROWNONE	B R OW N OW N
DAWNAND	D AO N AH N D
SOUTERRAINS	S AW T AH R EY N Z
HIGGLY	HH IH G L IY
CIII	S IY IY
EYEWATER	AY W AO T ER
PUSSYWILLOWS	P UH S IY W IH L OW Z
YOUWITH	Y AW W AH TH
TRUSTLESS	T R AH S T L AH S
LIANAS	L AY AH N AH Z
CHAMULA	CH AE M Y UW L AH
TREMBLETH	T R EH M B AH L IH TH
PISSOIR	P IH S OY R
TAÄEN	T EY AH N
WHEREBUT	W EH R AH B AH T
MONEYCHANGER	M AH N IY CH EY N JH ER
PA'DNER	P AE D N AH R
MOONCLOUDS	M UW N K L AW D Z
CLAMPAND	K L AE M P AH N D
CALLITHUMP	K AE L AH TH AH M P
NRSV	EH N AA R EH S V
CHAMBRES	CH AE M B AH R Z
HERETOS	HH EH R AH T AH Z
GRILLING/MEAT	G R IH L IH NG M IY T
TASTEOF	T AE S T IY AH F
AIMES	EY M Z
PATHSIN	P AE TH S IH N
EACHBRILLIANTLY	IY CH B R IH L IY AE N T L IY
COLONIZING	K AA L AH N AY Z IH NG
DEBRIDING	D IY B R AY D IH NG
FILAREE	F AY L ER IY
KNOWES	N OW Z
SPEECHAND	S P IY CH AH N D
STITHY	S T IH TH IY
11	W AH N W AH N
SKINIAN	S K IH N IY AH N
BRISÉBUCKDANCER	B R IH Z AH K D AE N S AH R
WARMTHOF	W AO R M TH AH F
HECATOMBS	HH EH K AH T OW M Z
ICEFIELDS	AY S F IY L D Z
CRISTES	K R IH S T S
THEQUIET	TH EH K W IY T
CONSUMMATIONDEVOUTLY	K AH N S AH M AH SH AH N D IH V AW T L IY
ROSSES	R AA S AH Z
WHEYLES	W EY L Z
HELVELLYN	HH EH L V EH L AH N
GOADS	G OW D Z
NINCOMPATED	N IH NG K AH M P EY T AH D
LXVI	L K S V IY
TRAVERSALS	T R AE V ER S AH L Z
TRENTALS	T R EH N T AH L Z
SUBURBIAN	S AH B AH R B IY AH N
AGAINAS	AH G EY N AH Z
WEATHERBEATEN	W EH DH ER B IY T AH N
UNBE	AH N B IY
ARETHUSE	AE R AH TH UW Z
WAYLED	W EY L EH D
WORDSHEDMADE	W ER D SH EH D M EY D
MOONBEAMHIGHWAY	M UW N B IY M HH AY W EY
FINENOTHING	F AY N AH TH IH NG
HOIK	HH OY K
HOL	HH AA L
BECOM	B AH K AA M
HOKIDE	HH AH K AY D
TUBESRASPBERRY	T UW B Z R AE Z B EH R IY
GRANDDADDIES	G R AE N D AE D IY Z
GRANBY	G R AE N B IY
DAMIATA	D EY M IY AH T AH
ADELANTE	AE D AH L AH N T
REINHABITED	R IY IH N HH AE B AH T IH D
REAVED	R IY V D
UNSUCCESSES	AH N S AH K S EH S IH Z
HOUSESCLOSE	HH AW S IH Z K L OW Z
MONICKER	M AH N IH K AH R
RIPTIDE	R IH P T AY D
THEREUNWONTEDLY	TH IY R UW N W AA N T EH D L IY
BODIESMUST	B OW D IY Z M AH S T
TAPYCER	T AH P AY S AH R
CONCEAVES	K AA N S IY V Z
BUSTE	B AH S T
CORYDON	K OW R IY D AA N
TRAMYSSENE	T R AE M AH S IY N
BASTILE	B AE S T AH L
HYEAHD	HH AY IY D
DAHLIAS	D AE L IY AH Z
HIRONDELLE	HH AH R AA N D AH L
ENGAG	EH N G AE G
SWIMAND	S W IH M AH N D
ARISEI	AE R AH S IY
MACBOOK	M AE K B AH K
HUSKILY	HH AH S K IY L IY
RADIANCEAT	R EY D IY AH N S IY T
UNPURGED	AH N P ER JH D
GRACHTS	G R AE CH T S
METATRON	M AH T AE T R AH N
LOOSEFROM	L UW S EH F R AH M
CULVERTS	K AH L V AH R T S
STONEMASON	S T OW N M EY S AH N
DIMINUTIVESIZE	D AH M IH N Y AH T IH V S AY Z
SEEWHO	S IY W HH OW
PELLUCID	P EH L UW S AH D
UNOPENEDTWO	AH N AA P AH N EH D T W OW
VIETCONGS	V IY T AH NG Z
MARRIOTTS	M AE R IY AH T S
UNLIKEREALLY	AH N L AY K R IY L IY
ONDDREADLOCK	AA N D R IY D L AH K
WITHTANGLEHEAD	W IH TH T AE NG G AH L HH EH D
SAIDSHE	S EY D SH
PRENDRE	P R IY N D AH R
SOLIDE	S AH L AY D
CROSSEDTHE	K R AA S AH D
DRAWETH	D R AO IH TH
SÉBASTIEN	S B AE S T IY AH N
SECRETSI	S EH K R EH T S IY
CHAIRAND	CH AE AH R AH N D
CONTENTWOULD	K AA N T EH N T W OW L D
SWEETVAPORS	S W IY T V EY P ER Z
TASE	T EY Z
ADONA	AE D AH N AH
8/22	EY T UW T UW
SIDEWAYSGUNS	S AY D W EY Z G AH N Z
ABEÄN	AH B IY AH N
CHILLERS	CH IH L ER Z
COLLAPSINGALWAYS	K AH L AE P S IH NG AH L W EY Z
REVEREDOR	R IH V IH ER D ER
DELICIOUSAND	D AH L IH S IY AW S AH N D
MANUFACTORY	M AE N Y UW F AH K T AO R IY
ROOMSINGULAR	R UW M S IH NG G Y AH L ER
CORDUROYED	K AO R D AH R OY D
DRILLINGS	D R IH L IH NG Z
RAISD	R EY Z D
RANDIER	R AE N D IY ER
HEPPLEWHITE	HH EH P L AH HH AY T
CALLOUR	K AE L AH R
MUSHING	M AH SH AH NG
NAXOS	N AE K S AH Z
SUMACHS	S UW M AH CH S
SLUFF	S L AH F
WOODBORER	W UH D B AO R ER
BECOMINGFEATHERS	B IH K AH M IH NG F EH DH ER Z
YOUFILL	Y AW F AH L
TRILEVEL	T R IH L AH V AH L
AQUAFORTE	AE K W AH F AO R T EY
GISBORNE	JH IH Z AH R N
WATCHD	W AA CH D
REGIONALNIGHT	R IY JH AH N AH L N AY T
POÈMES	P OW M Z
HANDSIZE	HH AE N D S AY Z
HANDSTWO	HH AE N D S T W OW
GREASEBALLS	G R IY S B AO L Z
GANGRENOUS	G AE N G R AH N AH S
EXTRÊMEMENT	IH K S T R M EH N T
ADVERSARIE	AE D V ER S ER IY
CHILIAD	CH IH L IY AH D
EFFEN	EH F AH N
DALLIERS	D AE L IY R Z
GENÉE	JH IY N
MILIJ	M IH L AH JH
COLOREDY	K AH L ER D IY
GLASSTHAT	G L AE S TH AH T
WAYNING	W EY N AH NG
WEAVERBIRD	W IY V ER B ER D
WHITEBIRCH	W AY T B ER CH
SHARPLYTHAT	SH AA R P L AH TH AH T
LADYFISH	L EY D IY F IH SH
VISUALIZEAN	V IH S W AH L AY Z IY AH N
MAYAND	M EY AH N D
/SLICK	S L IH K
DOMO	D OW M OW
STOKOWSKI	S T AH K OW S IY
PHONEPERSON	F OW N P ER S AH N
PUTTI	P AH T IY
EYEDAND	EY AH D AH N D
WINDPIPE	W IH N D P AY P
HETHER	HH EH DH AH R
LATEROS	L EY T ER AA S
RESEMBLESA	R AH S EH M B L AH S AH
INVIERNO	IH N V IY R N OW
VALASQUEZ	V AH L AE S W AH Z
SPIRITOUS	S P IH R AH T AH S
LISPINGLY	L IH S P IH NG L IY
ANIMALWE	AE N AH M AH L W
'NAY	N EY IY
USUFRUCTU	Y UW S AH F R AH K T UW
SHADDER	SH AE D AH R
RETSINA	R IH T S IH N AH
REMEMBERINGTHE	R AH M EH M B AH R AH N G
THINGMAJIG	TH IH N G M AH JH AH G
WANT'ST	W AA N T S T
PINWHEEL	P IH N W IY L
ALTED	AE L T AH D
BUSTIERS	B AH S T IY ER Z
DOBRE	D OW B AH R
CROSST	K R AA S T
HELIXES	HH EH L AH K S
HALOTOLERANT	HH EY L OW T AA L ER AH N T
SWALLOWTAIL	S W AA L OW T EY L
SNA	S N AA
CONSUELO	K AA N S UW AH L OW
BEACONLESS	B IY K AH N L AH S
PRINCEDOMS	P R IH N S D AH M Z
PRECIOUSLY	P R EH SH AH S L IY
HUTHMORE	HH AH TH M AH R
HIDINGS	HH AY D IH NG Z
FALC	F AE L K
GILLYFLOWER	G IH L IY F L AW ER
WANETH	W EY N IH TH
LASHES–MARIGOLD	L AH SH EH Z M AE R AH G OW L D
ONEGENTLY	AA N AH JH EH N T L IY
PARTAKEN	P AA R T EY K AH N
MEXICOTHE	M EH K S AH K OW DH
NORTH/SOUTH	N AO R TH S AW TH
CARESSTHE	K AE R AH S DH
TWANGLING	T W AA N G L AH NG
SNOWMEN	S N OW M EH N
SIDETHRUST	S AY D TH R AH S T
SLYAND	S L AY AH N D
THUMBMARKS	TH AH M AA R K S
MULCIBER	M UH L S AY B AH R
DISMISSD	D IH S M IH S D
PCW	P IY S IY W
GLOBETO	G L AA B AH T OW
PRECIOUSNESS	P R EH SH AH S N AH S
VISIONEDBY	V IH ZH AH N D B AY
ALTOSTRATUS	AE L T AH S T R EY T AH S
HATSHEPSUT*	HH AE T EH P S AH T
AUBERGINES	AO B AH R JH AY N Z
NUMBERON	N AH M B ER AO N
LIVINGONE	L IH V AH N G OW N
TANTOS	T AE N T AH Z
TWER	T W EH R
KUTHIWA	K AH TH AH W AH
BLANDEN	B L AE N D AH N
BLOWZY	B L OW Z IY
WOOLHE	W UW L HH
GRANDADDY	G R AE N D AE D IY
EUGENIDES	Y UW JH AH N AY D Z
EVVYSIMON	EH V IH S AH M AH N
CHILDRENSIGH	CH IH L D R AH N S AY
UNCHILDING	AH N CH AY L D IH NG
CXVII	K S V IY
FENESTRATION	F EH N AH S T R AE SH AH N
ARROZ	AE R AH Z
BLOODSPOTS	B L AH D S P AA T S
¿BUENO	B Y UW AH N OW
SCHOPEN	S K OW P AH N
OUTTO	AW T OW
ASHBUT	AE SH B AH T
DOWRIES	D AW R IY Z
SHARONA	SH AE R AH N AH
BEACHT	B AH AE CH T
GLORYIN	G L OW R IY IH N
\\|/	
GABBLING	G AE B AH L IH NG
DIORAMAIT	D AY AO R AH M EY T
UNDERPAINTED	AH N D ER P EY N T IH D
TURTLING	T ER T AH L IH NG
GWC	JH IY D AH B AH L Y UW K
STIES	S T AY Z
PARAPLUIE	P AH R AE P L UW
WELLFED	W EH L F EH D
SOLV	S OW L V
ECHOEYE	EH K OW AY
NOVELTHAT	N AH V EH L TH AH T
WILLKILL	W IH L K IH L
GRANDSIRES	G R AE N D S AY ER Z
STRATIGRAPHY	S T R AH T IH G R AH F IY
EXCESSAND	IH K S EH S AH N D
COACHWILL	K OW CH W IH L
TAWS	T AO Z
INSIGNIAS	IH N S IH G N IY AH Z
JONQUILS	JH AA N K W AH L Z
SCAPES	S K EY P S
RECORDS/SET	R IH K AO R D Z S EH T
LEVAVI	L EH V AH V IY
IPSE	IH P S
SCOURE	S K OW Y AH R
RESOLV	R AH S OW L V
ÁO	OW
MERCYII	M AH R S AY IY
ROWERS	R OW ER Z
HOGWEED	HH AA G W IY D
FUSAO	F Y UW S EY OW
EUPHELIA	Y UW F IY L Y AH
NOONSHINE	N UW N SH AY N
